"a" = (/turf/open/space/basic,/area/space)
"d" = (/obj/effect/decal/cleanable/blood/footprints{dir = 4},/turf/open/floor/plating,/area/awaymission/karlsmine/caves)
"e" = (/turf/closed/wall/rust,/area/awaymission/karlsmine/caves)
"k" = (/obj/effect/landmark/latejoin,/turf/open/floor/plating,/area/awaymission/karlsmine/caves)
"l" = (/obj/machinery/portable_atmospherics/canister/oxygen,/obj/effect/decal/cleanable/blood/footprints{dir = 1},/turf/open/floor/plating,/area/awaymission/karlsmine/caves)
"m" = (/turf/closed/indestructible/rock,/area/space)
"o" = (/obj/machinery/vending/boozeomat/all_access,/turf/open/floor/plating,/area/awaymission/karlsmine/caves)
"p" = (/obj/effect/decal/cleanable/blood/footprints{dir = 1},/obj/effect/decal/cleanable/blood/footprints{dir = 8},/turf/open/floor/plating,/area/awaymission/karlsmine/caves)
"x" = (/obj/structure/table,/turf/open/floor/plating,/area/awaymission/karlsmine/caves)
"y" = (/obj/effect/decal/cleanable/oil/slippery,/turf/open/floor/plating,/area/awaymission/karlsmine/caves)
"z" = (/obj/effect/decal/cleanable/blood/footprints{dir = 1},/turf/open/floor/plating,/area/awaymission/karlsmine/caves)
"C" = (/obj/structure/table,/obj/item/kinetic_crusher{pixel_x = -5},/obj/item/kinetic_crusher{pixel_x = 5},/obj/item/kinetic_crusher,/turf/open/floor/plating,/area/awaymission/karlsmine/caves)
"E" = (/turf/closed/mineral,/area/space)
"F" = (/obj/structure/table/wood,/turf/open/floor/plating,/area/awaymission/karlsmine/caves)
"I" = (/obj/machinery/gateway/away,/turf/open/floor/plating,/area/awaymission/karlsmine/caves)
"L" = (/obj/effect/decal/cleanable/oil/slippery,/obj/effect/decal/cleanable/oil,/obj/effect/decal/cleanable/blood/footprints{dir = 1},/turf/open/floor/plating,/area/awaymission/karlsmine/caves)
"M" = (/turf/open/floor/plating,/area/awaymission/karlsmine/caves)
"Q" = (/obj/machinery/door/airlock/external/ruin{welded = 1},/turf/open/floor/plating,/area/awaymission/karlsmine/caves)
"R" = (/obj/effect/decal/cleanable/blood/footprints{dir = 8},/turf/open/floor/plating,/area/awaymission/karlsmine/caves)
"T" = (/obj/structure/table,/obj/item/pickaxe{pixel_x = -5},/obj/item/gun/energy/recharge/kinetic_accelerator,/turf/open/floor/plating,/area/awaymission/karlsmine/caves)
"U" = (/obj/structure/table/wood,/obj/item/flashlight/lantern,/turf/open/floor/plating,/area/awaymission/karlsmine/caves)
"V" = (/obj/effect/decal/cleanable/blood/footprints{dir = 8},/obj/effect/decal/cleanable/blood/footprints{dir = 1},/turf/open/floor/plating,/area/awaymission/karlsmine/caves)
"X" = (/obj/item/chair,/obj/effect/decal/cleanable/blood,/obj/effect/decal/cleanable/blood/gibs/old,/turf/open/floor/plating,/area/awaymission/karlsmine/caves)
"Y" = (/turf/open/misc/asteroid,/area/space)
"Z" = (/turf/closed/wall,/area/awaymission/karlsmine/caves)

(1,1,1) = {"
aaaaaaaaaaaaaaaaaaaaaaaaaaaaaaaaaaaaaaaaaaaaaaaaaaaaaaaaaaaaaaaaaaaaaaaaaaaaaaaaaaaaaaaaaaaaaaaaaaaaaaaaaaaaaaaaaaaaaaaaaaaaaaaaaaaaaaaaaaaaaaaaaaaaaa
aaaaaaaaaaaaaaaaaaaaaaaaaaaaaaaaaaaaaaaaaaaaaaaaaaaaaaaaaaaaaaaaaaaaaaaaaaaaaaaaaaaaaaaaaaaaaaaaaaaaaaaaaaaaaaaaaaaaaaaaaaaaaaaaaaaaaaaaaaaaaaaaaaaaaa
aaaaaaaaaaaaaaaaaaaaaaaaaaaaaaaaaaaaaaaaaaaaaaaaaaaaaaaaaaaaaaaaaaaaaaaaaaaaaaaaaaaaaaaaaaaaaaaaaaaaaaaaaaaaaaaaaaaaaaaaaaaaaaaaaaaaaaaaaaaaaaaaaaaaaa
aaaaaaaaaaaaaaaaaaaaaaaaaaaaaaaaaaaaaaaaaaaaaaaaaaaaaaaaaaaaaaaaaaaaaaaaaaaaaaaaaaaaaaaaaaaaaaaaaaaaaaaaaaaaaaaaaaaaaaaaaaaaaaaaaaaaaaaaaaaaaaaaaaaaaa
aaaaaaaaaaaaaaaaaaaaaaaaaaaaaaaaaaaaaaaaaaaaaaaaaaaaaaaaaaaaaaaaaaaaaaaaaaaaaaaaaaaaaaaaaaaaaaaaaaaaaaaaaaaaaaaaaaaaaaaaaaaaaaaaaaaaaaaaaaaaaaaaaaaaaa
aaaaaaaaaaaaaaaaaaaaaaaaaaaaaaaaaaaaaaaaaaaaaaaaaaaaaaaaaaaaaaaaaaaaaaaaaaaaaaaaaaaaaaaaaaaaaaaaaaaaaaaaaaaaaaaaaaaaaaaaaaaaaaaaaaaaaaaaaaaaaaaaaaaaaa
aaaaaaaaaaaaaaaaaaaaaaaaaaaaaaaaaaaaaaaaaaaaaaaaaaaaaaaaaaaaaaaaaaaaaaaaaaaaaaaaaaaaaaaaaaaaaaaaaaaaaaaaaaaaaaaaaaaaaaaaaaaaaaaaaaaaaaaaaaaaaaaaaaaaaa
aaaaaaaaaaaaaaaaaaaaaaaaaaaaaaaaaaaaaaaaaaaaaaaaaaaaaaaaaaaaaaaaaaaaaaaaaaaaaaaaaaaaaaaaaaaaaaaaaaaaaaaaaaaaaaaaaaaaaaaaaaaaaaaaaaaaaaaaaaaaaaaaaaaaaa
aaaaaaaaaaaaaaaaaaaaaaaaaaaaaaaaaaaaaaaaaaaaaaaaaaaaaaaaaaaaaaaaaaaaaaaaaaaaaaaaaaaaaaaaaaaaaaaaaaaaaaaaaaaaaaaaaaaaaaaaaaaaaaaaaaaaaaaaaaaaaaaaaaaaaa
aaaaaaaaaaaaaaaaaaaaaaaaaaaaaaaaaaaaaaaaaaaaaaaaaaaaaaaaaaaaaaaaaaaaaaaaaaaaaaaaaaaaaaaaaaaaaaaaaaaaaaaaaaaaaaaaaaaaaaaaaaaaaaaaaaaaaaaaaaaaaaaaaaaaaa
aaaaaaaaaaaaaaaaaaaaaaaaaaaaaaaaaaaaaaaaaaaaaaaaaaaaaaaaaaaaaaaaaaaaaaaaaaaaaaaaaaaaaaaaaaaaaaaaaaaaaaaaaaaaaaaaaaaaaaaaaaaaaaaaaaaaaaaaaaaaaaaaaaaaaa
aaaaaaaaaaaaaaaaaaaaaaaaaaaaaaaaaaaaaaaaaaaaaaaaaaaaaaaaaaaaaaaaaaaaaaaaaaaaaaaaaaaaaaaaaaaaaaaaaaaaaaaaaaaaaaaaaaaaaaaaaaaaaaaaaaaaaaaaaaaaaaaaaaaaaa
aaaaaaaaaaaaaaaaaaaaaaaaaaaaaaaaaaaaaaaaaaaaaaaaaaaaaaaaaaaaaaaaaaaaaaaaaaaaaaaaaaaaaaaaaaaaaaaaaaaaaaaaaaaaaaaaaaaaaaaaaaaaaaaaaaaaaaaaaaaaaaaaaaaaaa
aaaaaaaaaaaaaaaaaaaaaaaaaaaaaaaaaaaaaaaaaaaaaaaaaaaaaaaaaaaaaaaaaaaaaaaaaaaaaaaaaaaaaaaaaaaaaaaaaaaaaaaaaaaaaaaaaaaaaaaaaaaaaaaaaaaaaaaaaaaaaaaaaaaaaa
aaaaaaaaaaaaaaaaaaaaaaaaaaaaaaaaaaaaaaaaaaaaaaaaaaaaaaaaaaaaaaaaaaaaaaaaaaaaaaaaaaaaaaaaaaaaaaaaaaaaaaaaaaaaaaaaaaaaaaaaaaaaaaaaaaaaaaaaaaaaaaaaaaaaaa
aaaaaaaaaaaaaaaaaaaaaaaaaaaaaaaaaaaaaaaaaaaaaaaaaaaaaaaaaaaaaaaaaaaaaaaaaaaaaaaaaaaaaaaaaaaaaaaaaaaaaaaaaaaaaaaaaaaaaaaaaaaaaaaaaaaaaaaaaaaaaaaaaaaaaa
aaaaaaaaaaaaaaaaaaaaaaaaaaaaaaaaaaaaaaaaaaaaaaaaaaaaaaaaaaaaaaaaaaaaaaaaaaaaaaaaaaaaaaaaaaaaaaaaaaaaaaaaaaaaaaaaaaaaaaaaaaaaaaaaaaaaaaaaaaaaaaaaaaaaaa
aaaaaaaaaaaaaaaaaaaaaaaaaaaaaaaaaaaaaaaaaaaaaaaaaaaaaaaaaaaaaaaaaaaaaaaaaaaaaaaaaaaaaaaaaaaaaaaaaaaaaaaaaaaaaaaaaaaaaaaaaaaaaaaaaaaaaaaaaaaaaaaaaaaaaa
aaaaaaaaaaaaaaaaaaaaaaaaaaaaaaaaaaaaaaaaaaaaaaaaaaaaaaaaaaaaaaaaaaaaaaaaaaaaaaaaaaaaaaaaaaaaaaaaaaaaaaaaaaaaaaaaaaaaaaaaaaaaaaaaaaaaaaaaaaaaaaaaaaaaaa
aaaaaaaaaaaaaaaaaaaaaaaaaaaaaaaaaaaaaaaaaaaaaaaaaaaaaaaaaaaaaaaaaaaaaaaaaaaaaaaaaaaaaaaaaaaaaaaaaaaaaaaaaaaaaaaaaaaaaaaaaaaaaaaaaaaaaaaaaaaaaaaaaaaaaa
aaaaaaaaaaaaaaaaaaaaaaaaaaaaaaaaaaaaaaaaaaaaaaaaaaaaaaaaaaaaaaaaaaaaaaaaaaaaaaaaaaaaaaaaaaaaaaaaaaaaaaaaaaaaaaaaaaaaaaaaaaaaaaaaaaaaaaaaaaaaaaaaaaaaaa
aaaaaaaaaaaaaaaaaaaaaaaaaaaaaaaaaaaaaaaaaaaaaaaaaaaaaaaaaaaaaaaaaaaaaaaaaaaaaaaaaaaaaaaaaaaaaaaaaaaaaaaaaaaaaaaaaaaaaaaaaaaaaaaaaaaaaaaaaaaaaaaaaaaaaa
aaaaaaaaaaaaaaaaaaaaaaaaaaaaaaaaaaaaaaaaaaaaaaaaaaaaaaaaaaaaaaaaaaaaaaaaaaaaaaaaaaaaaaaaaaaaaaaaaaaaaaaaaaaaaaaaaaaaaaaaaaaaaaaaaaaaaaaaaaaaaaaaaaaaaa
aaaaaaaaaaaaaaaaaaaaaaaaaaaaaaaaaaaaaaaaaaaaaaaaaaaaaaaaaaaaaaaaaaaaaaaaaaaaaaaaaaaaaaaaaaaaaaaaaaaaaaaaaaaaaaaaaaaaaaaaaaaaaaaaaaaaaaaaaaaaaaaaaaaaaa
aaaaaaaaaaaaaaaaaaaaaaaaaaaaaaaaaaaaaaaaaaaaaaaaaaaaaaaaaaaaaaaaaaaaaaaaaaaaaaaaaaaaaaaaaaaaaaaaaaaaaaaaaaaaaaaaaaaaaaaaaaaaaaaaaaaaaaaaaaaaaaaaaaaaaa
aaaaaaaaaaaaaaaaaaaaaaaaaaaaaaaaaaaaaaaaaaaaaaaaaaaaaaaaaaaaaaaaaaaaaaaaaaaaaaaaaaaaaaaaaaaaaaaaaaaaaaaaaaaaaaaaaaaaaaaaaaaaaaaaaaaaaaaaaaaaaaaaaaaaaa
aaaaaaaaaaaaaaaaaaaaaaaaaaaaaaaaaaaaaaaaaaaaaaaaaaaaaaaaaaaaaaaaaaaaaaaaaaaaaaaaaaaaaaaaaaaaaaaaaaaaaaaaaaaaaaaaaaaaaaaaaaaaaaaaaaaaaaaaaaaaaaaaaaaaaa
aaaaaaaaaaaaaaaaaaaaaaaaaaaaaaaaaaaaaaaaaaaaaaaaaaaaaaaaaaaaaaaaaaaaaaaaaaaaaaaaaaaaaaaaaaaaaaaaaaaaaaaaaaaaaaaaaaaaaaaaYYaaaaaaaaaaaaaaaaaaaaaaaaaaaa
aaaaaaaaaaaaaaaaaaaaaaaaaaaaaaaaaaaaaaaaaaaaaaaaaaaaaaaaaaaaaaaaaaaaaaaaaaaaaaaaaaaaaaaaaaaaaaaaaaaaaaaaaaaaaaaaaaaaaaYaYYaaaaaaaaaaaaaaaaaaaaaaaaaaaa
aaaaaaaaaaaaaaaaaaaaaaaaaaaaaaaaaaaaaaaaaaaaaaaaaaaaaaaaaaaaaaaaaaaaaaaaaaaaaaaaaaaaaaaaaaaaaaaaaaaaaaaaaaaaaaaaaaaaaaYYYYaaaaaaaaaaaaaaaaaaaaaaaaaaaa
aaaaaaaaaaaaaaaaaaaaaaaaaaaaaaaaaaaaaaaaaaaaaaaaaaaaaaaaaaaaaaaaaaaaaaaaaaaaaaaaaaaaaaaaaaaaaaaaaaaaaaaaaaaaaaaaaaaaaaaYYYaaaaaaaaaaaaaaaaaaaaaaaaaaaa
aaaaaaaaaaaaaaaaaaaaaaaaaaaaaaaaaaaaaaaaaaaaaaaaaaaaaaaaaaaaaaaaaaaaaaaaaaaaaaaaaaaaaaaaaaaaaaaaaaaaaaaaaaaaaaaaaaaaaaaYYYaaaaaaaaaaaaaaaaaaaaaaaaaaaa
aaaaaaaaaaaaaaaaaaaaaaaaaaaaaaaaaaaaaaaaaaaaaaaaaaaaaaaaaaaaaaaaaaaaaaaaaaaaaaaaaaaaaaaaaaaaaaaaaaaaaaaaaaaaaaaaaaaYYYYYYaaaaaaaaaaaaaaaaaaaaaaaaaaaaa
aaaaaaaaaaaaaaaaaaaaaaaaaaaaaaaaaaaaaaaaaaaaaaaaaaaaaaaaaaaaaaaaaaaaaaaaaaaaaaaaaaaaaaaaaaaaaaaaaaaaaaaaaaaaaaaaaaYYYYYYYaaaaaaaaaaaaaaaaaaaaaaaaaaaaa
aaaaaaaaaaaaaaaaaaaaaaaaaaaaaaaaaaaaaaaaaaaaaaaaaaaaaaaaaaaaaaaaaaaaaaaaaaaaaaaaaaaaaaaaaaaaaaaaaaaaaaaaaaaaaaaaaaYYYYYaaaaaaaaaaaaaaaaaaaaaaaaaaaaaaa
aaaaaaaaaaaaaaaaaaaaaYYYYYYYYYYaaaaaaaaaaaaaaaaaaaaaaaaaaaaaaaaaaaaaaaaaaaaaaaaaaaaaaaaaaaaaaaaaaaaaaaaaaaaaaaaaaYYYYaaaaaaaaaaaaaaaaaaaaaaaaaaaaaaaaa
aaaaaaaaaaaaaaaaaaaYYYYYYYYYYYYYYYaaaaaaaaaaaaaaaaaaaaaaaaaaaaaaaaaaaaaaaaaaaaaaaaaaaaaaaaaaaaaaaaaaaaaaaaaaaaaaaYYYaaaaaaaaaaaaaaaaaaaaaaaaaaaaaaaaaa
aaaaaaaaaaaaaaaaaYYYYYYYYYYYYYYYYYYaaaaaaaaaaaaaaaaaaaaaaaaaaaaaaaaaaaaaaaaaaaaaaaaaaaaaaaaaaaaaaaaaaaaaaaaaaaaaYYYaaaaaaaaaaaaaaaaaaaaaaaaaaaaaaaaaaa
aaaaaaaaaaaaaaaaYYYaaaaaYYYYYYYYYYYYYYYaaaaaaaaaaaaaaaaaaaaaaaaaaaaaaaaaaaaaaaaaaaaaaaaaaaaaaaaaaaaaaaaaaaaaaaaaYYYaaaaaaaaaaaaaaaaaaaaaaaaaaaaaaaaaaa
aaaaaaaaaaaaaaaaYaaaaaaaaaaaaaYYYYYYYYYaaaaaaaaaaaaaaaaaaaaaaaaaaaaaaaaaaaaaaaaaaaaaaaaaaaaaaaaaaaaaaaaaaaaaaaaYYYYaaaaaaaaaaaaaaaaaaaaaaaaaaaaaaaaaaa
aaaaaaaaaaaaaaaaaaaaaaaaaaaaaaaaaaYYYYYaaaaaaaaaaaaaaaaaaaaaaaaaaaaaaaaaaaaaaaaaaaaaaaaaaaaaaaaaaaaaaaaaaaaaaaaYYYYaaaaaaaaaaaaaaaaaaaaaaaaaaaaaaaaaaa
aaaaaaaaaaaaaaaaaaaaaaaaaaaaaaaaaaYYYYYYYaaaaaaaaaaaaaaaaaaaaaaaaaaaaaaaaaaaaaaaaaaaaaaaaaaaaaaaaaaaaaaaaaaaaaaYYYaaaaaaaaaaaaaaaaaaaaaaaaaaaaaaaaaaaa
aaaaaaaaaaaaaaaaaaaaaaaaaaaaaaaaaaaaaYYYYYaaaaaaaaaaaaaaaaaaaaaaaaaaaaaaaaaaaaaaaaaaaaaaaaaaaaaaaaaaaaaaaaaaaaaYYYaaaaaaaaaaaaaaaaaaaaaaaaaaaaaaaaaaaa
aaaaaaaaaaaaaaaaaaaaaaaaaaaaaaaaaaaaaaaYYYYaaaaaaaaaaaaaaaaaaaaaaaaaaaaaaaaaaaaaaaaaaaaaaaaaaaaaaaaaaaaaaaaaaaaYYYaaaaaaaaaaaaaaaaaaaaaaaaaaaaaaaaaaaa
aaaaaaaaaaaaaaaaaaaaaaaaaaaaaaaaaaaaaaaYYYYaaaaaaaaaaaaaaaaaaaaaaaaaaaaaaaaaaaaaaaaaaaaaaaaaaaaaaaaaaaaaaaaaaaaaYYYaaaaaaaaaaaaaaaaaaaaaaaaaaaaaaaaaaa
aaaaaaaaaaaaaaaaaaaaaaaaaaaaaaaaaaaaaaaaaYYYaaaaaaaaaaaaaaaaaaaaaaaaaaaaaaaaaaaaaaaaaaaaaaaaaaaaaaaaaaaaaaaaaaaaYYYYYaaaaaaaaaaaaaaaaaaaaaaaaaaaaaaaaa
aaaaaaaaaaaaaaaaaaaaaaaaaaaaaaaaaaaaaaaaaYYYaaaaaaaaaaaaaaaaaaaaaaaaaaaaaaYYaaaaaaaaaaYYYaaaaaaaaaaaaaaaaaaaaaaaaYYYYYYYYYaaaaaaaaaaaaaaaaaaaaaaaaaaaa
aaaaaaaaaaaaaaaaaaaaaaaaaaaaaaaaaaaaaaaaaaYYYYaaaaaaaaaaaaaaaaaaaaaaaaYaYYYYYYYaYaaaaYYYYYaaaaaaaaaaaaaaaaaaaaaaaaYYYYYYYYYYYYYaaaaaaaaaaaaaaaaaaaaaaa
aaaaaaaaaaaaaaaaaaaaaaaaaaaaaaaaaaaaaaaaaaaYYYaaaaaaaaaaaaaaaaaaaaYYYYYYYYYYYYYYYYYYYYYYYYaaaaaaaaaaaaaaaaaaaaaaaaaYYYYYYYYYYYYYYYaaaaaaaaaaaaaaaaaaaa
aaaaaaaaaaaaaaaaaaaaaaaaaaaaaaaaaaaaaaaaaaaYYYYaaaaaaaaaaaaaaaaYYYYYYYYaaaaaaaaYYYYYYYYYYYYaaaaaaaaaaaaaaaaaaaaaaaaaaYYYYYYYYYYYYYYYYYaaaaaaaaaaaaaaaa
aaaaaaaaaaaaaaaaaaaaaaaaaaaaaaaaaaaaaaaaaaaaYYYaaaaaaaaaaaaaYYYYYYYYYaaaaaaaaaaaaaYYYYYYYYYaaaaaaaaaaaaaaaaaaaaaaaaaaaaaaaaaYYYYYYYYYYaaaaaaaaaaaaaaaa
aaaaaaaaaaaaYYaaaaaaaaaaaaaaaaaaaaaaaaaaaaaaaYYaaaaaaaaaaYYYYYYYYaaaaaaaaaaaaaaaaaaaYYYYYYYaaaaaaaaaaaaaaaaaaaaaaaaaaaaaaaaaaaYYYYYYYYYaaaaaaaaaaaaaaa
aaaaaaaaaaaaYYYaaaaaaaaaaaaaaaaaaaaaaaaaaaaaaaYYaaaaaaaYYYYYYaaaaaaaaaaaaaaaaaaaaaaaaYYYYYYaaaaaaaaaaaaaaaaaaaaaaaaaaaaaaaaaaaaaYYYYYYYaaaaaaaaaaaaaaa
aaaaaaaaaaaaYYYaaaaaaaaaaaaaaaaaaaaaaaaaaaaaaaYYYaaaaYYYYYaaaaaaaaaaaaaaaaaaaaaaaaaaaYYYYYaaaaaaaaaaaaaaaaaaaaaaaaaaaaaaaaaaaaaaaYYYYYYYaaaaaaaaaaaaaa
aaaaaaaaaaaaaYYaaaaaaaaaaaaaaaaaaaaaaaaaaaaaaaaYYYYYYYYYaaaaaaaaaaaaaaaaaaaaaaaaaaaaaYYYYaaaaaaaaaaaaaaaaaaaaaaaaaaaaaaaaaaaaaaaaaYYYYYYYaaaaaaaaaaaaa
aaaaaaaaaaaYYYYYYYYYYYYYaaaaaaaaaaaaaaaaaaaaaaaaYYYYYYaaaaaaaaaaaaaaaaaaaaaaaaaaaaaaaaaaaaaaaaaaaaaaaaaaaaaaaaaaaaaaaaaaaaaaaaaaaaaYYYYYYYaaaaaaaaaaaa
aaaaaaaaaaaYYYYYYYYYYYYYYYYYaaaaaaaaaaaaaaaaaaaaYYYYYYaaaaaaaaaaaaaaaaaaaaaaaaaaaaaaaaaaaaaaaaaaaaaaaaaaaaaaaaaaaaaaaaaaaaaaaaaaaaaYYaYYYYaaaaaaaaaaaa
aaaaaaaaaaaYYYYYYaYYYYYYYYYYaaaaaaaaaaaaaaaaaaaaaYYYYYaaaaaaaaaaaaaaaaaaaaaaaaaaaaaaaaaaaaaaaaaaYYYYYYYaaaaaaaaaaaaaaaaaaaaaaaaaaaaaaaaYYYaaaaaaaaaaaa
aaaaaaaaaaaYYaYYaaaaaaYYYaaaaaaaaaaaaaaaaaaaaaaaaaYYYaaaaaaaaaaaaaaaaaaaaaaaaaaaaaaaaaaaaaaaaaaYYYYYYYYYaaaaaaaaaaaaaaaaaaaaaaaaaaaaaaaaYYYaaaaaaaaaaa
aaaaaaaaaaYYYaYYaaaaaaaYYaaaaaaaaaaaaaaaaaaaaaaaaaYYYaaaaaaaaaaaaaaaaaaaaaaaaaaaaaaaaaaaaaaaaaaaYYYYYYYYYYaaaaaaaaaaaaaaaaaaaaaaaaaaaaaaYYYaaaaaaaaaaa
aaaaaaaaaaYYYaYaaaaaaaaaaaaaaaaaaaaaaaaaaaaaaaaaaYYYYaaaaaaaaaaaaaaaaaaaaaaaaaaaaaaaaaaaaaaaaaaaaaaaaaYYYYYYaaaaaaaaaaaaaaaaaaaaaaaaaaaaYYYaaaaaaaaaaa
aaaaaaaaaaYYYaaaaaaaaaaaaaaaaaaaaaaaaaaaaaaaaaaaaaYYYaaaaaaaaaaaaaaaaaaaaaaaaaaaaaaaaaaaaaaaaaaaaaaaaaaaYYYYYaaaaaaaaaaaaaaaaaaaaaaaaaaaYYYaaaaaaaaaaa
aaaaaaaaaaYYYaaaaaaaaaaaaaaaaaaaaaaaaaaaaaaaaaaaaaYYYaaaaaaaaaaaaaaaaaaaaaaaaaaaaaaaaaaaaaaaaaaaaaaaaaaaaYYYYYYaaaaaaaaaaaaaaaaaaaaaaaaaYYYaaaaaaaaaaa
aaaaaaaaaaaYYaaaaaaaaaaaaaaaaaaaaaaaaaaaaaaaaaaaaaYYYaaaaaaaaaaaaaaaaaaaaaaaaaaaaaaaaaaaaaaaaaaaaaaaaaaaaaYYYYYYaaaaaaaaaaaaaaaaaaaaaaaaYYYaaaaaaaaaaa
aaaaaaaaaaaYYYaaaaaaaaaaaaaaaaaaaaaaaaaaaaaaaaaaaaYYYaaaaaaaaaaaaaaaaaaaaaaaaaaaaaaaaaaaaaaaaaaaaaaaaaaaaaaaYYYYYaaaaaaaaaaaaaaaaaaaaaaaYYYaaaaaaaaaaa
aaaaaaaaaaYYYYYaaaaaaaaaaaaaaaaaaaaaaaaaaaaaaaaaaaYYYaaaaaaaaaaaaaaaaaaaaaaaaaaaaaaaaaaaaaaaaaaaaaaaaaaaaaaaaYYYYYYaaaaaaaaaaaaaaaaaaaaaYYYaaaaaaaaaaa
aaaaaaaaaYYYYYYYYYaaaaaaaaaaaaaaaaaaaaaaaaaaaaaaaaYYYaaaaaaaaaaaaaaaaaaaaaaaaaaaaaaaaaaaaaaaaaaaaaaaaaaaaaaaaaYYYYYaaaaaaaaaaaaaaaaaaaaaYYYaaaaaaaaaaa
aaaaaaaaYYYYYYYYYYYYYYYYYYYaaaaaaaaaaaaaaaaaaaaaaaYYYaaaaaaaaaaaaaaaaaaaaaaaaaaaaaaaaaaaaaaaaaaaaaaaaaaaaaaaaaaYYYYYaaaaaaaaaaaaaaaaaaaYYYYaaaaaaaaaaa
aaaaaaaaYYYYYYYYYYYYYYYYYYYYYaaaaaaaaaaaaaaaaaaaaYYYYaaaaaaaaaaaaaaaaaaaaaaaaaaaaaaaaaaaaaaaaaaaaaaaaaaaaaaaaaaaYYYYaaaaaaaaaaaaaaaaaaaYYYaaaaaaaaaaaa
aaaaaaaaaYYYYYYYYYYYYYYYYYYYYYaaaaaaaaaaaaaaaaaaaYYYYaaaaaaaaaaaaaaaaaaaaaaaaaaaaaaaaaaaaaaaaaaaaaaaaaaaaaaaaaaaaYYYYaaaaaaaaaaaaaaaaaYYYYaaaaaaaaaaaa
aaaaaaaaaaYYYYYaaaaaaaaaaYYYYYYYaaaaaaaaaaaaaaaaaYYYaaaaaaaaaaaaaaaaaaaaaaaaaaaaaaaaaaaaaaaaaaaaaaaaaaaaaaaaaaaaaaYYYaaaaaaaaaaaaaaaaaYYYaaaaaaaaaaaaa
aaaaaaaaaYYYYaaaaaaaaaaaaaaaYYYYYaYaYYYaaaaaaaaaYYYYaaaaaaaaaaaaaaaaaaaaaaaaaaaaaaaaaaaaaaaaaaaaaaaaaaaaaaaaaaaaaaYYYaaaaaaaaaaaaaaaaYYYYaaaaaaaaaaaaa
aaaaaaaaaYYYaaaaaaaaaaaaaaaaaaYYYYYYYYYYaaaaaaaaYYYYYaaaaaaaaaaaaaaaaaaaaaaaaaaaaaaaaaaaaaaaaaaaaaaaaaaaaaaaaaaaaaaYYYaaaaaaaaaaaaaaYYYYaaaaaaaaaaaaaa
aaaaaaaaaYYYaaaaaaaaaaaaaaaaaaaYYYYYYYYYaaaaaaaaaYYYYYaaaaaaaaaaaaaaaaaaaaaaaaaaaaaaaaaaaaaaaaaaaaaaaaaaaaaaaaaaaaaYYYYaaaaaaaaaaaaaYYYaaaaaaaaaaaaaaa
aaaaaaaaaYYYaaaaaaaaaaaaaaaaaaaYYYYYYYYYYaaaaaaaaaYYYYaaaaaaaaaaaaaaaaaaaaaaaaaaaaaaaaaaaaaaaaaaaaaaaaaaaaaaaaaaaaaaYYYYYYYaaaaaaaaaYYYaaaaaaaaaaaaaaa
aaaaaaaaYYYYaaaaaaaaaaaaaaaaaaaYYYYYYYYYaaaaaaaaaaaYYYaaaaaaaaaaaaaaaaaaaaaaaaaaaaaaaaaaaaaaaaaaaaaaaaaaaaaaaaaaaaaaYYYYYYYYYaaaaaaaYYaaaaaaaaaaaaaaaa
aaaaaaaaYYYaaaaaaaaaaaaaaaaaaaaYYYYYYYYYYaaaaaaaaaaYYYaaaaaaaaaaaaaaaaaaaaaaaaaaaaaaaaaaaaaaaaaaaaaaaaaaaaaaaaaaaaaaYYYYYYYYYYaaaaaaYYaaaaaaaaaaaaaaaa
aaaaaaaaYYYaaaaaaaaaaaaaaaaaaaYYYYYYYYYYYaaaaaaaaaaYYYYaaaaaaaaaaaaaaaaaaaaaaaaaaaaaaaaaaaaaaaaaaaaaaaaaaaaaaaaaaaaaYYYYYYYYYYYYYaaaYYYaaaaaaaaaaaaaaa
aaaaaaaaYYYaaaaaaaaaaaaaaaaaaaYYYYYYYYYYYaaaaaaaaaaaYYYaaaaaaaaaaaaaaaaaaaaaaaaaaaaaaaaaaaaaaaaaaaaaaaaaaaaaaaaaaaaYYYYYaaaaYYYYYYYaYYYaaaaaaaaaaaaaaa
aaaaaaaYYYaaaaaaaaaaaaaaaaaaaaYYYYYYYYYYaaaaaaaaaaaaYYYaaYYYYYYYYYYYYYYaaaaaaaaaaaaaaaaaaaaaaaaaaaaaaaaaaaaaaaaaaaYYYYYaaaaaaYYYYYYYYYYaaaaaaaaaaaaaaa
aaaaaaaaYYaaaaaaaaaaaaaaaaaaaaaaYYYYYYYaaaaaaaaaaaaaYYYYYYYYYYYYYYYYYYYYYaaaaaaaaaaaaaaaaaaaaaaaaaaaaaaaaaaaaaaaaYYYYaaaaaaaaaaYYYYYYYYaaaaaaaaaaaaaaa
aaaaaaaYYYaaaaaaaaaaaaaaaaaaaaaaaYYYYYaaaaaaaaaaaaaaYYYYYYYYYYYYYYYYYYYYYYYaaaaaaaaaaaaaaaaaaaaaaaaaaaaaaaaaaaYYYYYYaaaaaaaaaaaaaaYYYYYaaaaaaaaaaaaaaa
aaaaaaaaYYYaaaaaaaaaaaaaaaaaaaaaaaYYYYaaaaaaaaaaaaaYYYYYaaaaaaaaaaaaYYYYYYYYaaaaaaaaaaaaaaaaaaaaaaaaaaaaaaaaYYYYYYaaaaaaaaaaaaaaaaaaYYYaaaaaaaaaaaaaaa
aaaaaaaaYYYYaaaaaaaaaaaaaaaaaaaaaaaYYaaaaaaaaaaaaaYYYYaaaaaaaaaaaaaaaaYYYYYYYaaaaaaaaaaaaaaaaaYYaaaaaaaaaaaYYYYYYaaaaaaaaaaaaaaaaaaaaaaaaaaaaaaaaaaaaa
aaaaaaaaaYYYYaaaaaaaaaaaaaaaaaaaaaaaaaaaaaaaaaaaYYYYYaaaaaaaaaaaaaaaaaaaYYYYYaaaaaaaaaaaaaaaaaYYYaaaaaaaaYYYYYYYaaaaaaaaaaaaaaaaaaaaaaaaaaaaaaaaaaaaaa
aaaaaaaaaYYYaaaaaaaaaaaaaaaaaaaaaaaaaaaaaaaaaaaYYYYYaaaaaaaaaaaaaaaaaaaaaYYYYYaaaaaaaaaaaaaaaaaYYYaaaaaaYYYYYYYaaaaaaaaaaaaaaaaaaaaaaaaaaaaaaaaaaaaaaa
aaaaaaaaaaYYYaaaaaaaaaaaaaaaaaaaaaaaaaaaaaaaaaYYYYYaaaaaaaaaaaaaaaaaaaaaaaYYYYaaaaaaaaaaaaaaaaaaYYYYYaaYYYYYaaaaaaaaaaaaaaaaaaaaaaaaaaaaaaaaaaaaaaaaaa
aaaaaaaaaYYYYYYaaaaaaaaaaaaaaaaaaaaaaaaaaaaaaYYYYaaaaaaaaaaaaaaaaaaaaaYYYYYYYYaaaaaaaaaaaaaaaaaaYYYYYYYYYYYaaaaaaaaaaaaaaaaaaaaaaaaaaaaaaaaaaaaaaaaaaa
aaaaaaaaaYYYYYYaaaaaaaaaaaaaaaaaaaaaaaaaaaaaYYYYYaaaaaaaaaaaaaaaaaaaaYYYYYYYYYaaaaaaaaaaaaaaaaaaaYYYYYYYYYaaaaaaaaaaaaaaaaaaaaaaaaaaaaaaaaaaaaaaaaaaaa
aaaaaaaaaaaYYYYaaaaaaaaaaaaaaaaaaaaaaaaaaaaYYYYYaaaaaaaaaaaaaaaaaaaaYYYYYYYYYYaaaaaaaaaaaaaaaaaaaaYYYYYYYaaaaaaaaaaaaaaaaaaaaaaaaaaaaaaaaaaaaaaaaaaaaa
aaaaaaaaaaaaYYYaaaaaaaaaaaaaaaaaaaaaaaaaaYYYYYaaaaaaaaaaaaaaaaaaaaaYYYYYYaaYYaaaaaaaaaaaaaaaaaaaaaaYYYYYYaaaaaaaaaaaaaaaaaaaaaaaaaaaaaaaaaaaaaaaaaaaaa
aaaaaaaaaaaYYYYaaaaaaaaaaaaaaaaaaaaaaaaaYYYYYaaaaaaaaaaaaaaaaaaaaaaYYYYYYYaaaaaaaaaaaaaaaaaaaaaaaaaYYYYYYaaaaaaaaaaaaaaaaaaaaaaaaaaaaaaaaaaaaaaaaaaaaa
aaaaaaaaaaaaYYaaaaaaaaaaaaaaaaaaaaaaaaaaYYYYYYYYYaaaaaaaaaaaaaaaaaaYYYYYYYYaaaaaaaaaaaaaaaaaaaaaaaaaYYYYYaaaaaaaaaaaaaaaaaaaaaaaaaaaaaaaaaaaaaaaaaaaaa
aaaaaaaaaaaYYYYaaaaaaaaaaaaaaaaaaaaaaaaYYYYYYYYYYYYYaaaaaaaaaaaaaaaYYYYYYYYYaaaaaaaaaaaaaaaaaaaaaaaaYYYYYaaaaaaaaaaaaaaaaaaaaaaaaaaaaaaaaaaaaaaaaaaaaa
aaaaaaaaaaYYYYaaaaaaaaaaaaaaaaaaaaaaaaYYYYYYYYYYYYYYYYaaaaaaaaaaaaaaYYYYYYYYaaaaaaaaaaaaaaaaaaaaaaaaaYYYYaaaaaaaaaaaaaaaaaaaaaaaaaaaaaaaaaaaaaaaaaaaaa
aaaaaaaaaYYYYYaaaaaaaaaaaaaaaaaaaaaaaYYYYYYYaaYYYYYYYYYaaaaaaaaaaaaYYYYYYYYYaaaaaaaaaaaaaaaaaaaaaaaaaaYYYaaaaaaaaaaaaaaaaaaaaaaaaaaaaaaaaaaaaaaaaaaaaa
aaaaaaaaaaYYYYYYaaaaaaaaaaaaaaaaaaaaYYYYYYYaaaaYYYYYYYYYaaaaaaaaaaaaaYYYYYYYaaaaaaaaaaaaaaaaaaaaaaaaaaYYYaaaaaaaaaaaaaaaaaaaaaaaaaaaaaaaaaaaaaaaaaaaaa
aaaaaaaaaaYYYYaaaaaaaaaaaaaaaaaaaaaaYYYYYYaaaaaaYYYYYYYYYaaaaaaaaaaaaaYYYYYYYaaaaaaaaaaaaaaaaaaaaaaaaaYYYaaaaaaaaaaaaaaYYYYYYYYaaaaaaaaaaaaaaaaaaaaaaa
aaaaaaaaaYYYYYaaaaaaaaaaaaaaaaaaaaaaYYYYYaaaaaaaaYYYYYYYYYaaaaaaaaaaaaaaaaaaaaaaaaaaaaaaaaaaaaaaaaaaaaYYYaaaaaaaaaaaaaYYYYYYYYYYYaaaaaaaaaaaaaaaaaaaaa
aaaaaaaaaYYYYYaaaaaaaaaaaaaaaaaaaaaaYYYYYaaaaaaaaaYYYYYYYYYaaaaaaaaaaaaaaaaaaaaaaaaaaaaaaaaaaaaaaaaaaaYYYaaaaaaaaaaaaaYYYYYYYYYYYYaaaaaaaaaaaaaaaaaaaa
aaaaaaaaYYYYYYaaaaaaaaaaaaaaaaaaaaaaYYYYaaaaaaaaaaaaaYYYYYYYaaaaaaaaaaaaaaaaaaaaaaaaaaaaaaaaaaaaaaaaaaYYYaaaaaaaaaaaaYYYYYYYYYYYYYYaaaaaaaaaaaaaaaaaaa
aaaaaaaaaYYYYaaaaaaaaaaaaaaaaaaaaaaYYYYYaaaaaaaaaaaaaaYYYYYYYaaaaaaaaaaaaaaaaaaaaaaaaaaaaaaaaaaaaaaaaYYYYaaaaaaaaaaaYYYYYYYYYYYYYYYaaaaaaaaaaaaaaaaaaa
aaaaaaaaaYYYYaaaaaaaaaaaaaaaaaaaaaaYYYYaaaaaaaaaaaaaaaaYYYYYYYYYaaaaaaaaaaaaaaaaaaaaaaaaaaaaaaaaaaaaaYYYaaaaaaaaaaaYYYYYYYYYYYYYYYYaaaaaaaaaaaaaaaaaaa
aaaaaaaaYYYYYaaaaaaaaaaaaaaaaaaaaaaYYYYaaaaaaaaaaaaaaaaaYYYYYYYYYYaaaaaaaaaaaaaaaaaaaaaaaaaaaaaaaaaaYYYYaaaaaaaaaaYYYYYYYYYYYYYYYYYaaaaaaaaaaaaaaaaaaa
aaaaaaaaaaYYYaaaaaaaaaaaaaaaaaaaaaaYYYYaaaaaaaaaaaaaaaaaaYYYYYYYYYYYYYYaaaaaaaaaYYYYYaaaaaaaaaaaaaaaYYYYaaaaaaaaaYYYYYYYYYYYYYYYYYYaaaaaaaaaaaaaaaaaaa
aaaaaaaaaaYYYaaaaaaaaaaaaaaaaaaaaaYYYYYaaaaaaaaaaaaaaaaaaaYYYYYYYYYYYYYYYYaaaaYYYYYYYYYYaYYaaaaaaaaYYYYYaaaaaaaaaYYYYYYYYYYYYYYYYYYaaaaaaaaaaaaaaaaaaa
aaaaaaaaaaYYYaaaaaaaaaaaaaaaaaaaaaYYYYYaaaaaaaaaaaaaaaaaaaaYYYYYYYYYYYYYYaaaaYYYYYYYYYYYYYYYYaaaaaYYYYYaaaaaaaaaYYYYYYYYYYYYYYYYYYYaaaaaaaaaaaaaaaaaaa
aaaaaaaaaaYYYaaaaaaaaaaaaaaaaaaaaaYYYYYaaaaaaaaaaaaaaaaaaaaaaYYYYYYYYYYYYaaaYYYYYYYYYYYYYYYYYYYYaaYYYYYaaaaaaaYYYYYYYYYYYYYYYYYYYYYaaaaaaaaaaaaaaaaaaa
aaaaaaaaaaYYYaaaaaaaaaaaaaaaaaaaaYYYYYYaaaaaaaaaaaaaaaaaaaaaaaaYYYYYYYYYYYYYYYYYYYYYYYYYYYYYYYYYYYYYYYYYYYYYYYYYYYYYYYYYYYYYYYYYYYYaaaaaaaaaaaaaaaaaaa
aaaaaaaaaaYYYaaaaaaaaaaYYYYYaaaaaYYYYYYaaaaaaaaaaaaaaaaaaaaaaaaaaaaYYYYYYYYYYYYYYYYYYYYYYYYYYYYYYYYYYYYYYYYYYYYYYYYYYYYYYYYYYYYYYYYaaaaaaaaaaaaaaaaaaa
aaaaaaaaaaYYYYaaaaaaaYYYYYYYYYYYYYYYYYYaaaaaaaaaaaaaaaaaaaaaaaaaaaaaaaaaYYYYYYYaaaaaaaaaaYYYYaaaaaaaaaaaaaaaaaaYYYYYYYYYYYYYYYYYYYYaaaaaaaaaaaaaaaaaaa
aaaaaaaaaYYYYYaaaaaYYYYYYYYYYYYYYYYYYYYaaaaaaaaaaaaaaaaaaaaaaaaaaaaaaaaaYYYYaaaaaaaaaaaaaaYYYYaaaaaaaaaaaaaaaaaaaaYYYYYYYYYYYYYYYYYaaaaaaaYaaaaaaaaaaa
aaaaaaaaaYYYYYaaaYYYYYYYYYYYYYYYYYYYYYYaaaaaaaaaaaaaaaaaaaaaaaaaaaaaaaaaYYYYaaaaaaaaaaaaaaaYYYaaaaaaaaaaaaaaaaaaaaaYYYYYYYYYYYYYYYaaaaaaaYYYaaaaaaaaaa
aaaaaaaaaaYYYYaYYYYYYYYYYaYYYYYYYYYYYYYYaaaaaaaaaaaaaaaaaaaaaaaaaaaaaaaYYYYYaaaaaaaaaaaaaaaYYYaaaaaaaaaaaaaaaaaaaaaaYYYYYYYYYYYYYaaaaaaaaYYYYaaaaaaaaa
aaaaaaaaaaYYYYYYYYYYYYYYaaaaYYYYaYYYYYYYYaaaaaaaaaaaaaaaaaaaaaaaaaaaaaYYYYYYaaaaaaaaaaaaaaaYYYaaaaaaaaaaaYYaaaaaaaaaYYYYYYYYYYYYaaaaaaaaaYYYYYaaaaaaaa
aaaaaaaaaaYYYYYYYYYaaaaaaaaaaaaaaaaaYYYYYYaaaaaaaaaaaaaaaaaaaaaaaaaaaaYYYYYaaaaaaaaaaaaaaaaaYYaaaaaaaaaaaYYYYaaaaaaaYYYYYYYYYYYaaaaaaaaaaYYYYYYaaaaaaa
aaaaaaaaaYYYYYYYYYaaaaaaaaaaaaaaaaaaYYYYYYYaaaaaaaaaaaaaaaaaaaaaaaaaaaaYYYaaaaaaaaaaaaaaaaaaYYYaaaaaaaaaaaaYYYaaaaaaaYYYYYYYYaaaaaaaaaaaaYYYYYYaaaaaaa
aaaaaaaaYYYYYYYYYaaaaaaaaaaaaaaaaaaaaaYYYYYaaaaaaaaaaaaaaaaaaaaaaaaaaaYYYaaaaaaaaaaaaaaaaaaaYYYaaaaaaaaaaaaaYYaaaaaaaaaaaaaaaaaaaaaaaaaaaYYYYYYaaaaaaa
aaaaaaaaYYYYYYYaaaaaaaaaaaaaaaaaaaaaaaaaYYYYaaaaaaaaaaaaaaaaaaaaaaaaaYYYYaaaaaaaaaaaaaaaaaaaYYYYaaaaaaaaaaaaYYaaaaaaaaaaaaaaaaaaaaaaaaaaaYYYYYYaaaaaaa
aaaaaaaaYYYYYaaaaaaaaaaaaaaaaaaaaaaaaaaaaaYYYYaaaaaaaaaaaaaaaaaaaaaaYYYYaaaaaaaaaaaaaaaaaaaaaYYYaaaaaaaaaaaaYYYaaaaaaaaaaaaaaaaaaaaaaaaaaYYYYYYaaaaaaa
aaaaaaaYYYYYYaaaaaaaaaaaaaaaaaaaaaaaaaaaaaYYYYaaaaaaaaaaaaaaaaaaaaaYYYYYaaaaaaaaaaaaaaaaaaaaaYYYaaaaaaaaaaaaYYYaaaaaaaaaaaaaaaaaaaaaaaaaaaYYYYYaaaaaaa
aaaaaaaaYYYYYaaaaaaaaaaaaaaaaaaaaaaaaaaaaaaYYYaaaaaaaaaaaaaaaaaaaaaaYYYaaaaaaaaaaaaaaaaaaaaaaYYYYaaaaaaaaaaYYYYaaaaaaaaaaaaaaaaaaaaaaaaaaaYYYYYaaaaaaa
aaaaaaaaYYYYYaaaaaaaaaaaaaaaaaaaaaaaaaaaaaaaYYYaaaaaaaaaaaaaaaaaaaaYYYaaaaaaaaaaaaaaaaaaaaaaaaYYYYaaaaaaaaYYYaaaaaaaaaaaaaaaaaaaaaaaaaaaaaYYYYYaaaaaaa
aaaaaaaaaaYYYaaaaaaaaaaaaaaaaaaaaaaaaaaaaaaaYYYaaaaaaaaaaaaaaaaaaaYYYYaaaaaaaaaaaaaaaaaaaaaaaaYYYYaaaaaaaaYYaaaaaaaaaaaaaaaaaaaaaaaaaaaaaaYYYYYaaaaaaa
aaaaaaaaaaYYYaaaaaaaaaaaaaaaaaaaaaaaaaaaaaaaYYYYaaaaaaaaaaaaaaaaaYYYYYaaaaaaaaaaaaaaaaaaaaaaaaaYYYaaaaaaaYYYaaaaaaaaaaaaaaaaaaaaaaaaaaaaaaYYYYYaaaaaaa
aaaaaaaaaaYYYaaaaaaaaaaaaaaaaaaaaaaaaaaaaaaaaYYYaaaaaaaaaaaaaaaaYYYYYaaaaaaaaaaaaaaaaaaaaaaaaaaYYYYaaaaYYYYaaaaaaaaaaaaaaaaaaaaaaaaaaaaaaYYYYYYaaaaaaa
aaaaaaaaaYYYYaaaaaaaaaaaaaaaaaaaaaaaaaaaaaaaaaYYaaaaaaaaaaaaaaaYYYYYYaaaaaaaaaaaaaaaaaaaaaaaaaaaaYYYaYYYYYaaaaaaaaaaaaaaaaaaaaaaaaaaaaaaaYYYYYYaaaaaaa
aaaaaaaaYYYYYaaaaaaaaaaaaaaaaaaaaaaaaaaaaaaaaYYaaaaaaaaaaaaaaaaaYYYYaaaaaaaaaaaaaaaaaaaaaaaaaaaaaYYYYYYYYaaaaaaaaaaaaaaaaaaaaaaaaaaaaaaaaYYYYYYaaaaaaa
aaaaaaaYYYYYYaaaaaaaaaaaaaaaaaaaaaaaaaaaaaaaYYYaaaaaaaaaaaaaaaaYYYYaaaaaaaaaaaaaaaaaaaaaaaaaaaaaaaYYYYYaaaaaaaaaaaaaaaaaaaaaaaaaaaaaaaaaaYYYYYaaaaaaaa
aaaaaaYYYYYYYaaaaaaaaaaaaaaaaaaaaaaaaaaaaaaYYYaaaaaaaaaaaaaaaaaYYYaaaaaaaaaaaaaaaaaaaaaaaaaaaaaaaaaYYYYYaaaaaaaaaaaaaaaaaaaaaaaaaaaaaaaaYYYYYYaaaaaaaa
aaaaaYYYYYYaaaaaaaaaaaaaaaaaaaaaaaaaaaaaaaaYYYaaaaaaaaaaaaaaaaaYYYaaaaaaaaaaaaaaaaaaaaaaaaaaaaaaaaaaYYYYYYYaaaaaaaaaaaaaaaaaaaaaaaaaaaaaYYYYYaaaaaaaaa
aaaaaYYYYYYaaaaaaaaaaaaaaaaaaaaaaaaaaaaaaaYYYYaaaaaaaaaaaaaaaaaYYYaaaaaaaaaaaaaaaaaaaaaaaaaaaaaaaaaaaaYYYYYYaaaaaaaaaaaaaaaaaaaaaaaaaaaaYYYYYaaaaaaaaa
aaaaYYYYYYYaaaaaaaaaaaaaaaaaaaaaaaaaaaaaaYYYYaaaaaaaaaaaaaaaaaaYYYYaaaaaaaaaaaaaaaaaaaaaaaaaaaaaaaaaaaaYYYYYYYYaaaaaaaaaaaYYaYYYaaaaaaaaYYYYYaaaaaaaaa
aaaaYYYYYYYaaaaaaaaaaaaaaaaaaaaaaaaaaaaaYYYYaaaaaaaaaaaaaaaaaaaYYYYaaaaaaaaaaaaaaaaaaaaaaaaaaaaaaaaaaaaaaYYYYYYYaaaaaaaaaYYYYYYYYYaaaaaaYYYYaaaaaaaaaa
aaaaYYYYYYYaaaaaaaaaaaaaaYaaaaaaaaaaaaaaYYYaaaaaaaaaaaaaaaaaaaaYYYYaaaaaaaaaaaaaaaaaaaaaaaaaaaaaaaaaaaaaaaaaYYYYYaaaaaaaYYYYaaaYYYYaaaaaYYYYaaaaaaaaaa
aaaZZZeQeeZZaaaaaaaaaaaaaYYaaaaaaaaaaaaYYaaaaaaaaaaaaaaaaaaaaaaaYYYYaaaaaaaaaaaaaaaaaaaaaaaaaaaaaaaaaaaaaaaaaYYYYaaaaaaaaaaYaaaYYYYaaaaYYYYaaaaaaaaaaa
aaaeMMMzMxxZaaaaaaaaaaaaYYYaaaaaaaaaaYYYaaaaaaaaaaaaaaaaaaaaaaaaYYYYYYYYaaaaaaaaaaaaaaaaaaaaaaaaaaaaaaaaaaaaaaaaaaaaaaaaaaaaaaaaYYYYaaYYYYYaaaaaaaaaaa
aaaZMMMVRpCZaaaaaaaaaaaaYYYaaaaaaaaaYYYaaaaaaaaaaaaaaaaaaaaaaaaaaYYYYYYYYaaaaaaaaaaaaaaaaaaaaaaaaaaaaaaaaaaaaaaaaaaaaaaaaaaaaaaaaYYYYYYYYaaaaaaaaaaaaa
aaaZTMMMMLMeaaaaaaaaaaaYYYYYaaaaaaaYYYYaaaaaaaaaaaaaaaaaaaaaaaaaaaaYYYYYYaaaaaaaaaaaaaaaaaaaaaaaaaaaaaaaaaaaaaaaaaaaaaaaaaaaaaaaaaYYYYYYYaaaaaaaaaaaaa
mEEZTMMMMzMZEEmaaaaaaaaYYYYYaaaaaaYYYYYaaaaaaaaaaaaaaaaaaaaaaaaaaaaaaYYYYYYYaaaaaaaaaaaaaaaaaaaaaaaaaaaaaaaaaaaaaaaaaaaaaaaaaaaaaaaYYYYYaaaaaaaaaaaaaa
mEEZTyMMMlMeEEmaaaaaaaaaYYYYaaaaYYYYYYaaaaaaaaaaaaaaaaaaaaaaaaaaaaaaaaYYYYYYYYYaaaaaaaaaaaaaaaaaaaaaaaaaaaaaaaaaaaaaaaaaaaaaaaaaaaYYYYYaaaaaaaaaaaaaaa
mEEeTMMkMzMZEEmaaaaaaaaaaYYYaYYYYYYYaaaaaaaaaaaaaaaaaaaaaaaaaaaaaaaaaaaaYYYYYYYYYYaaaaaaaaaaaaaaaaaaaaaaaaaaaaaYYYYYYYYaaaaaaaaaaYYYYYaaaaaaaaaaaaaaaa
mEEZMMMMMzMZEEmaaaaaaaaaaYYYYYYYYYaaaaaaaaaaaaaaaaaaaaaaaaaaaaaaaaaaaaaaaaaYYYYYYYYYYaaaaaaaaaaaaaaaaaaYYYYYaYYYYYYYYYYYaaaaaaaYYYYYYaaaaaaaaaaaaaaaaa
mEEZMMMIMzMZEEmaaaaaaaaaaaYYYYYYYaaaaaaaaaaaaaaaaaaaaaaaaaaaaaaaaaaaaaaaaaaaaaYYYYYYYYYYYYYaaaaaaaaaaaYYYYYYYYYYYaaaaYYYYaYYaYYYYYYYaaaaaaaaaaaaaaaaaa
mEEeFUMMMLMeEEmaaaaaaaaaaaaYYYYYaaaaaaaaaaaaaaaaaaaaaaaaaaaaaaaaaaaaaaaaaaaaaaaaaaaaYYYYYYYYYYYYYaaaaYYYYYYYYYYaaaaaaYYYYYYYYYYYYYaaaaaaaaaaaaaaaaaaaa
mEEZXdddddoZEEmaaaaaaaaaaaaaaaaaaaaaaaaaaaaaaaaaaaaaaaaaaaaaaaaaaaaaaaaaaaaaaaaaaaaaaaaaaYYYYYYYYYYYYYYYYYaaaaaaaaaaaYYYYYYYYYYYYaaaaaaaaaaaaaaaaaaaaa
mEEZeZeZZeeZEEmaaaaaaaaaaaaaaaaaaaaaaaaaaaaaaaaaaaaaaaaaaaaaaaaaaaaaaaaaaaaaaaaaaaaaaaaaaaaaYYYYYYYYYYYYYaaaaaaaaaaaaYYYYYYYYYaaaaaaaaaaaaaaaaaaaaaaaa
mEEEEEEEEEEEEEmaaaaaaaaaaaaaaaaaaaaaaaaaaaaaaaaaaaaaaaaaaaaaaaaaaaaaaaaaaaaaaaaaaaaaaaaaaaaaaaaaaaaaaaaaaaaaaaaaaaaaaaaaaaaaaaaaaaaaaaaaaaaaaaaaaaaaaa
mEEEEEEEEEEEEEmaaaaaaaaaaaaaaaaaaaaaaaaaaaaaaaaaaaaaaaaaaaaaaaaaaaaaaaaaaaaaaaaaaaaaaaaaaaaaaaaaaaaaaaaaaaaaaaaaaaaaaaaaaaaaaaaaaaaaaaaaaaaaaaaaaaaaaa
mmmmmmmmmmmmmmmaaaaaaaaaaaaaaaaaaaaaaaaaaaaaaaaaaaaaaaaaaaaaaaaaaaaaaaaaaaaaaaaaaaaaaaaaaaaaaaaaaaaaaaaaaaaaaaaaaaaaaaaaaaaaaaaaaaaaaaaaaaaaaaaaaaaaaa
"}
