"a" = (/turf/open/space/basic,/area/space)
"d" = (/obj/effect/decal/cleanable/blood/footprints{dir = 4},/turf/open/floor/plating,/area/awaymission/karlsmine/caves)
"e" = (/turf/closed/wall/rust,/area/awaymission/karlsmine/caves)
"k" = (/obj/effect/landmark/latejoin,/turf/open/misc/asteroid,/area/space)
"l" = (/obj/machinery/portable_atmospherics/canister/oxygen,/obj/effect/decal/cleanable/blood/footprints{dir = 1},/turf/open/floor/plating,/area/awaymission/karlsmine/caves)
"m" = (/turf/closed/indestructible/rock,/area/space)
"o" = (/obj/machinery/vending/boozeomat/all_access,/turf/open/floor/plating,/area/awaymission/karlsmine/caves)
"p" = (/obj/effect/decal/cleanable/blood/footprints{dir = 1},/obj/effect/decal/cleanable/blood/footprints{dir = 8},/turf/open/floor/plating,/area/awaymission/karlsmine/caves)
"x" = (/obj/structure/table,/turf/open/floor/plating,/area/awaymission/karlsmine/caves)
"y" = (/obj/effect/decal/cleanable/oil/slippery,/turf/open/floor/plating,/area/awaymission/karlsmine/caves)
"z" = (/obj/effect/decal/cleanable/blood/footprints{dir = 1},/turf/open/floor/plating,/area/awaymission/karlsmine/caves)
"C" = (/obj/structure/table,/obj/item/kinetic_crusher{pixel_x = -5},/obj/item/kinetic_crusher{pixel_x = 5},/obj/item/kinetic_crusher,/turf/open/floor/plating,/area/awaymission/karlsmine/caves)
"E" = (/turf/closed/mineral,/area/space)
"F" = (/obj/structure/table/wood,/turf/open/floor/plating,/area/awaymission/karlsmine/caves)
"I" = (/obj/machinery/gateway/away,/turf/open/floor/plating,/area/awaymission/karlsmine/caves)
"L" = (/obj/effect/decal/cleanable/oil/slippery,/obj/effect/decal/cleanable/oil,/obj/effect/decal/cleanable/blood/footprints{dir = 1},/turf/open/floor/plating,/area/awaymission/karlsmine/caves)
"M" = (/turf/open/floor/plating,/area/awaymission/karlsmine/caves)
"Q" = (/obj/machinery/door/airlock/external/ruin{welded = 1},/turf/open/floor/plating,/area/awaymission/karlsmine/caves)
"R" = (/obj/effect/decal/cleanable/blood/footprints{dir = 8},/turf/open/floor/plating,/area/awaymission/karlsmine/caves)
"T" = (/obj/structure/table,/obj/item/pickaxe{pixel_x = -5},/obj/item/gun/energy/recharge/kinetic_accelerator,/turf/open/floor/plating,/area/awaymission/karlsmine/caves)
"U" = (/obj/structure/table/wood,/obj/item/flashlight/lantern,/turf/open/floor/plating,/area/awaymission/karlsmine/caves)
"V" = (/obj/effect/decal/cleanable/blood/footprints{dir = 8},/obj/effect/decal/cleanable/blood/footprints{dir = 1},/turf/open/floor/plating,/area/awaymission/karlsmine/caves)
"X" = (/obj/item/chair,/obj/effect/decal/cleanable/blood,/obj/effect/decal/cleanable/blood/gibs/old,/turf/open/floor/plating,/area/awaymission/karlsmine/caves)
"Y" = (/turf/open/misc/asteroid,/area/space)
"Z" = (/turf/closed/wall,/area/awaymission/karlsmine/caves)

(1,1,1) = {"
aaaaaaaaaaaaaaaaaaaaaaaaaaaaaaaaaaaaaaaaaaaaaaaaaaaaaaaaaaaaaaaaaaaaaaaaaaaaaaaaaaaaaaaaaaaaaaaaaaaaaaaaaaaaaaaaaaaaaaaaaaaaaaaaaaaaaaaaaaaaaaaaaaaaaa
aaaaaaaaaaaaaaaaaaaaaaaaaaaaaaaaaaaaaaaaaaaaaaaaaaaaaaaaaaaaaaaaaaaaaaaaaaaaaaaaaaaaaaaaaaaaaaaaaaaaaaaaaaaaaaaaaaaaaaaaaaaaaaaaaaaaaaaaaaaaaaaaaaaaaa
aaaaaaaaaaaaaaaaaaaaaaaaaaaaaaaaaaaaaaaaaaaaaaaaaaaaaaaaaaaaaaaaaaaaaaaaaaaaaaaaaaaaaaaaaaaaaaaaaaaaaaaaaaaaaaaaaaaaaaaaaaaaaaaaaaaaaaaaaaaaaaaaaaaaaa
aaaaaaaaaaaaaaaaaaaaaaaaaaaaaaaaaaaaaaaaaaaaaaaaaaaaaaaaaaaaaaaaaaaaaaaaaaaaaaaaaaaaaaaaaaaaaaaaaaaaaaaaaaaaaaaaaaaaaaaaaaaaaaaaaaaaaaaaaaaaaaaaaaaaaa
aaaaaaaaaaaaaaaaaaaaaaaaaaaaaaaaaaaaaaaaaaaaaaaaaaaaaaaaaaaaaaaaaaaaaaaaaaaaaaaaaaaaaaaaaaaaaaaaaaaaaaaaaaaaaaaaaaaaaaaaaaaaaaaaaaaaaaaaaaaaaaaaaaaaaa
aaaaaaaaaaaaaaaaaaaaaaaaaaaaaaaaaaaaaaaaaaaaaaaaaaaaaaaaaaaaaaaaaaaaaaaaaaaaaaaaaaaaaaaaaaaaaaaaaaaaaaaaaaaaaaaaaaaaaaaaaaaaaaaaaaaaaaaaaaaaaaaaaaaaaa
aaaaaaaaaaaaaaaaaaaaaaaaaaaaaaaaaaaaaaaaaaaaaaaaaaaaaaaaaaaaaaaaaaaaaaaaaaaaaaaaaaaaaaaaaaaaaaaaaaaaaaaaaaaaaaaaaaaaaaaaaaaaaaaaaaaaaaaaaaaaaaaaaaaaaa
aaaaaaaaaaaaaaaaaaaaaaaaaaaaaaaaaaaaaaaaaaaaaaaaaaaaaaaaaaaaaaaaaaaaaaaaaaaaaaaaaaaaaaaaaaaaaaaaaaaaaaaaaaaaaaaaaaaaaaaaaaaaaaaaaaaaaaaaaaaaaaaaaaaaaa
aaaaaaaaaaaaaaaaaaaaaaaaaaaaaaaaaaaaaaaaaaaaaaaaaaaaaaaaaaaaaaaaaaaaaaaaaaaaaaaaaaaaaaaaaaaaaaaaaaaaaaaaaaaaaaaaaaaaaaaaaaaaaaaaaaaaaaaaaaaaaaaaaaaaaa
aaaaaaaaaaaaaaaaaaaaaaaaaaaaaaaaaaaaaaaaaaaaaaaaaaaaaaaaaaaaaaaaaaaaaaaaaaaaaaaaaaaaaaaaaaaaaaaaaaaaaaaaaaaaaaaaaaaaaaaaaaaaaaaaaaaaaaaaaaaaaaaaaaaaaa
aaaaaaaaaaaaaaaaaaaaaaaaaaaaaaaaaaaaaaaaaaaaaaaaaaaaaaaaaaaaaaaaaaaaaaaaaaaaaaaaaaaaaaaaaaaaaaaaaaaaaaaaaaaaaaaaaaaaaaaaaaaaaaaaaaaaaaaaaaaaaaaaaaaaaa
aaaaaaaaaaaaaaaaaaaaaaaaaaaaaaaaaaaaaaaaaaaaaaaaaaaaaaaaaaaaaaaaaaaaaaaaaaaaaaaaaaaaaaaaaaaaaaaaaaaaaaaaaaaaaaaaaaaaaaaaaaaaaaaaaaaaaaaaaaaaaaaaaaaaaa
aaaaaaaaaaaaaaaaaaaaaaaaaaaaaaaaaaaaaaaaaaaaaaaaaaaaaaaaaaaaaaaaaaaaaaaaaaaaaaaaaaaaaaaaaaaaaaaaaaaaaaaaaaaaaaaaaaaaaaaaaaaaaaaaaaaaaaaaaaaaaaaaaaaaaa
aaaaaaaaaaaaaaaaaaaaaaaaaaaaaaaaaaaaaaaaaaaaaaaaaaaaaaaaaaaaaaaaaaaaaaaaaaaaaaaaaaaaaaaaaaaaaaaaaaaaaaaaaaaaaaaaaaaaaaaaaaaaaaaaaaaaaaaaaaaaaaaaaaaaaa
aaaaaaaaaaaaaaaaaaaaaaaaaaaaaaaaaaaaaaaaaaaaaaaaaaaaaaaaaaaaaaaaaaaaaaaaaaaaaaaaaaaaaaaaaaaaaaaaaaaaaaaaaaaaaaaaaaaaaaaaaaaaaaaaaaaaaaaaaaaaaaaaaaaaaa
aaaaaaaaaaaaaaaaaaaaaaaaaaaaaaaaaaaaaaaaaaaaaaaaaaaaaaaaaaaaaaaaaaaaaaaaaaaaaaaaaaaaaaaaaaaaaaaaaaaaaaaaaaaaaaaaaaaaaaaaaaaaaaaaaaaaaaaaaaaaaaaaaaaaaa
aaaaaaaaaaaaaaaaaaaaaaaaaaaaaaaaaaaaaaaaaaaaaaaaaaaaaaaaaaaaaaaaaaaaaaaaaaaaaaaaaaaaaaaaaaaaaaaaaaaaaaaaaaaaaaaaaaaaaaaaaaaaaaaaaaaaaaaaaaaaaaaaaaaaaa
aaaaaaaaaaaaaaaaaaaaaaaaaaaaaaaaaaaaaaaaaaaaaaaaaaaaaaaaaaaaaaaaaaaaaaaaaaaaaaaaaaaaaaaaaaaaaaaaaaaaaaaaaaaaaaaaaaaaaaaaaaaaaaaaaaaaaaaaaaaaaaaaaaaaaa
aaaaaaaaaaaaaaaaaaaaaaaaaaaaaaaaaaaaaaaaaaaaaaaaaaaaaaaaaaaaaaaaaaaaaaaaaaaaaaaaaaaaaaaaaaaaaaaaaaaaaaaaaaaaaaaaaaaaaaaaaaaaaaaaaaaaaaaaaaaaaaaaaaaaaa
aaaaaaaaaaaaaaaaaaaaaaaaaaaaaaaaaaaaaaaaaaaaaaaaaaaaaaaaaaaaaaaaaaaaaaaaaaaaaaaaaaaaaaaaaaaaaaaaaaaaaaaaaaaaaaaaaaaaaaaaaaaaaaaaaaaaaaaaaaaaaaaaaaaaaa
aaaaaaaaaaaaaaaaaaaaaaaaaaaaaaaaaaaaaaaaaaaaaaaaaaaaaaaaaaaaaaaaaaaaaaaaaaaaaaaaaaaaaaaaaaaaaaaaaaaaaaaaaaaaaaaaaaaaaaaaaaaaaaaaaaaaaaaaaaaaaaaaaaaaaa
aaaaaaaaaaaaaaaaaaaaaaaaaaaaaaaaaaaaaaaaaaaaaaaaaaaaaaaaaaaaaaaaaaaaaaaaaaaaaaaaaaaaaaaaaaaaaaaaaaaaaaaaaaaaaaaaaaaaaaaaaaaaaaaaaaaaaaaaaaaaaaaaaaaaaa
aaaaaaaaaaaaaaaaaaaaaaaaaaaaaaaaaaaaaaaaaaaaaaaaaaaaaaaaaaaaaaaaaaaaaaaaaaaaaaaaaaaaaaaaaaaaaaaaaaaaaaaaaaaaaaaaaaaaaaaaaaaaaaaaaaaaaaaaaaaaaaaaaaaaaa
aaaaaaaaaaaaaaaaaaaaaaaaaaaaaaaaaaaaaaaaaaaaaaaaaaaaaaaaaaaaaaaaaaaaaaaaaaaaaaaaaaaaaaaaaaaaaaaaaaaaaaaaaaaaaaaaaaaaaaaaaaaaaaaaaaaaaaaaaaaaaaaaaaaaaa
aaaaaaaaaaaaaaaaaaaaaaaaaaaaaaaaaaaaaaaaaaaaaaaaaaaaaaaaaaaaaaaaaaaaaaaaaaaaaaaaaaaaaaaaaaaaaaaaaaaaaaaaaaaaaaaaaaaaaaaaaaaaaaaaaaaaaaaaaaaaaaaaaaaaaa
aaaaaaaaaaaaaaaaaaaaaaaaaaaaaaaaaaaaaaaaaaaaaaaaaaaaaaaaaaaaaaaaaaaaaaaaaaaaaaaaaaaaaaaaaaaaaaaaaaaaaaaaaaaaaaaaaaaaaaaaaaaaaaaaaaaaaaaaaaaaaaaaaaaaaa
aaaaaaaaaaaaaaaaaaaaaaaaaaaaaaaaaaaaaaaaaaaaaaaaaaaaaaaaaaaaaaaaaaaaaaaaaaaaaaaaaaaaaaaaaaaaaaaaaaaaaaaaaaaaaaaaaaaaaaaaaaaaaaaaaaaaaaaaaaaaaaaaaaaaaa
aaaaaaaaaaaaaaaaaaaaaaaaaaaaaaaaaaaaaaaaaaaaaaaaaaaaaaaaaaaaaaaaaaaaaaaaaaaaaaaaaaaaaaaaaaaaaaaaaaaaaaaaaaaaaaaaaaaaaaaaYYaaaaaaaaaaaaaaaaaaaaaaaaaaaa
aaaaaaaaaaaaaaaaaaaaaaaaaaaaaaaaaaaaaaaaaaaaaaaaaaaaaaaaaaaaaaaaaaaaaaaaaaaaaaaaaaaaaaaaaaaaaaaaaaaaaaaaaaaaaaaaaaaaaaYaYYaaaaaaaaaaaaaaaaaaaaaaaaaaaa
aaaaaaaaaaaaaaaaaaaaaaaaaaaaaaaaaaaaaaaaaaaaaaaaaaaaaaaaaaaaaaaaaaaaaaaaaaaaaaaaaaaaaaaaaaaaaaaaaaaaaaaaaaaaaaaaaaaaaaYYYYaaaaaaaaaaaaaaaaaaaaaaaaaaaa
aaaaaaaaaaaaaaaaaaaaaaaaaaaaaaaaaaaaaaaaaaaaaaaaaaaaaaaaaaaaaaaaaaaaaaaaaaaaaaaaaaaaaaaaaaaaaaaaaaaaaaaaaaaaaaaaaaaaaaaYYYaaaaaaaaaaaaaaaaaaaaaaaaaaaa
aaaaaaaaaaaaaaaaaaaaaaaaaaaaaaaaaaaaaaaaaaaaaaaaaaaaaaaaaaaaaaaaaaaaaaaaaaaaaaaaaaaaaaaaaaaaaaaaaaaaaaaaaaaaaaaaaaaaaaaYYYaaaaaaaaaaaaaaaaaaaaaaaaaaaa
maaaaaaaaaaaaaaaaaaaaaaaaaaaaaaaaaaaaaaaaaaaaaaaaaaaaaaaaaaaaaaaaaaaaaaaaaaaaaaaaaaaaaaaaaaaaaaaaaaaaaaaaaaaaaaaaaaYYYYYYaaaaaaaaaaaaaaaaaaaaaaaaaaaaa
maaaaaaaaaaaaaaaaaaaaaaaaaaaaaaaaaaaaaaaaaaaaaaaaaaaaaaaaaaaaaaaaaaaaaaaaaaaaaaaaaaaaaaaaaaaaaaaaaaaaaaaaaaaaaaaaaYYYYYYYaaaaaaaaaaaaaaaaaaaaaaaaaaaaa
maaaaaaaaaaaaaaaaaaaaaaaaaaaaaaaaaaaaaaaaaaaaaaaaaaaaaaaaaaaaaaaaaaaaaaaaaaaaaaaaaaaaaaaaaaaaaaaaaaaaaaaaaaaaaaaaaYYYYYaaaaaaaaaaaaaaaaaaaaaaaaaaaaaaa
maaaaaaaaaaaaaaaaaaaaYYYYYYYYYYaaaaaaaaaaaaaaaaaaaaaaaaaaaaaaaaaaaaaaaaaaaaaaaaaaaaaaaaaaaaaaaaaaaaaaaaaaaaaaaaaaYYYYaaaaaaaaaaaaaaaaaaaaaaaaaaaaaaaaa
maaaaaaaaaaaaaaaaaaYYYYYYYYYYYYYYYaaaaaaaaaaaaaaaaaaaaaaaaaaaaaaaaaaaaaaaaaaaaaaaaaaaaaaaaaaaaaaaaaaaaaaaaaaaaaaaYYYaaaaaaaaaaaaaaaaaaaaaaaaaaaaaaaaaa
maaaaaaaaaaaaaaaaYYYYYYYYYYYYYYYYYYaaaaaaaaaaaaaaaaaaaaaaaaaaaaaaaaaaaaaaaaaaaaaaaaaaaaaaaaaaaaaaaaaaaaaaaaaaaaaYYYaaaaaaaaaaaaaaaaaaaaaaaaaaaaaaaaaaa
maaaaaaaaaaaaaaaYYYaaaaaYYYYYYYYYYYYYYYaaaaaaaaaaaaaaaaaaaaaaaaaaaaaaaaaaaaaaaaaaaaaaaaaaaaaaaaaaaaaaaaaaaaaaaaaYYYaaaaaaaaaaaaaaaaaaaaaaaaaaaaaaaaaaa
maaaaaaaaaaaaaaaYaaaaaaaaaaaaaYYYYYYYYYaaaaaaaaaaaaaaaaaaaaaaaaaaaaaaaaaaaaaaaaaaaaaaaaaaaaaaaaaaaaaaaaaaaaaaaaYYYYaaaaaaaaaaaaaaaaaaaaaaaaaaaaaaaaaaa
maaaaaaaaaaaaaaaaaaaaaaaaaaaaaaaaaYYYYYaaaaaaaaaaaaaaaaaaaaaaaaaaaaaaaaaaaaaaaaaaaaaaaaaaaaaaaaaaaaaaaaaaaaaaaaYYYYaaaaaaaaaaaaaaaaaaaaaaaaaaaaaaaaaaa
maaaaaaaaaaaaaaaaaaaaaaaaaaaaaaaaaYYYYYYYaaaaaaaaaaaaaaaaaaaaaaaaaaaaaaaaaaaaaaaaaaaaaaaaaaaaaaaaaaaaaaaaaaaaaaYYYaaaaaaaaaaaaaaaaaaaaaaaaaaaaaaaaaaaa
maaaaaaaaaaaaaaaaaaaaaaaaaaaaaaaaaaaaYYYYYaaaaaaaaaaaaaaaaaaaaaaaaaaaaaaaaaaaaaaaaaaaaaaaaaaaaaaaaaaaaaaaaaaaaaYYYaaaaaaaaaaaaaaaaaaaaaaaaaaaaaaaaaaaa
maaaaaaaaaaaaaaaaaaaaaaaaaaaaaaaaaaaaaaYYYYaaaaaaaaaaaaaaaaaaaaaaaaaaaaaaaaaaaaaaaaaaaaaaaaaaaaaaaaaaaaaaaaaaaaYYYaaaaaaaaaaaaaaaaaaaaaaaaaaaaaaaaaaaa
maaaaaaaaaaaaaaaaaaaaaaaaaaaaaaaaaaaaaaYYYYaaaaaaaaaaaaaaaaaaaaaaaaaaaaaaaaaaaaaaaaaaaaaaaaaaaaaaaaaaaaaaaaaaaaaYYYaaaaaaaaaaaaaaaaaaaaaaaaaaaaaaaaaaa
maaaaaaaaaaaaaaaaaaaaaaaaaaaaaaaaaaaaaaaaYYYaaaaaaaaaaaaaaaaaaaaaaaaaaaaaaaaaaaaaaaaaaaaaaaaaaaaaaaaaaaaaaaaaaaaYYYYYaaaaaaaaaaaaaaaaaaaaaaaaaaaaaaaaa
maaaaaaaaaaaaaaaaaaaaaaaaaaaaaaaaaaaaaaaaYYYaaaaaaaaaaaaaaaaaaaaaaaaaaaaaaYYaaaaaaaaaaYYYaaaaaaaaaaaaaaaaaaaaaaaaYYYYYYYYYaaaaaaaaaaaaaaaaaaaaaaaaaaaa
maaaaaaaaaaaaaaaaaaaaaaaaaaaaaaaaaaaaaaaaaYYYYaaaaaaaaaaaaaaaaaaaaaaaaYaYYYYYYYaYaaaaYYYYYaaaaaaaaaaaaaaaaaaaaaaaaYYYYYYYYYYYYYaaaaaaaaaaaaaaaaaaaaaaa
maaaaaaaaaaaaaaaaaaaaaaaaaaaaaaaaaaaaaaaaaaYYYaaaaaaaaaaaaaaaaaaaaYYYYYYYYYYYYYYYYYYYYYYYYaaaaaaaaaaaaaaaaaaaaaaaaaYYYYYYYYYYYYYYYaaaaaaaaaaaaaaaaaaaa
maaaaaaaaaaaaaaaaaaaaaaaaaaaaaaaaaaaaaaaaaaYYYYaaaaaaaaaaaaaaaaYYYYYYYYaaaaaaaaYYYYYYYYYYYYaaaaaaaaaaaaaaaaaaaaaaaaaaYYYYYYYYYYYYYYYYYaaaaaaaaaaaaaaaa
maaaaaaaaaaaaaaaaaaaaaaaaaaaaaaaaaaaaaaaaaaaYYYaaaaaaaaaaaaaYYYYYYYYYaaaaaaaaaaaaaYYYYYYYYYaaaaaaaaaaaaaaaaaaaaaaaaaaaaaaaaaYYYYYYYYYYaaaaaaaaaaaaaaaa
maaaaaaaaaaaYYaaaaaaaaaaaaaaaaaaaaaaaaaaaaaaaYYaaaaaaaaaaYYYYYYYYaaaaaaaaaaaaaaaaaaaYYYYYYYaaaaaaaaaaaaaaaaaaaaaaaaaaaaaaaaaaaYYYYYYYYYaaaaaaaaaaaaaaa
maaaaaaaaaaaYYYaaaaaaaaaaaaaaaaaaaaaaaaaaaaaaaYYaaaaaaaYYYYYYaaaaaaaaaaaaaaaaaaaaaaaaYYYYYYaaaaaaaaaaaaaaaaaaaaaaaaaaaaaaaaaaaaaYYYYYYYaaaaaaaaaaaaaaa
maaaaaaaaaaaYYYaaaaaaaaaaaaaaaaaaaaaaaaaaaaaaaYYYaaaaYYYYYaaaaaaaaaaaaaaaaaaaaaaaaaaaYYYYYaaaaaaaaaaaaaaaaaaaaaaaaaaaaaaaaaaaaaaaYYYYYYYaaaaaaaaaaaaaa
maaaaaaaaaaaaYYaaaaaaaaaaaaaaaaaaaaaaaaaaaaaaaaYYYYYYYYYaaaaaaaaaaaaaaaaaaaaaaaaaaaaaYYYYaaaaaaaaaaaaaaaaaaaaaaaaaaaaaaaaaaaaaaaaaYYYYYYYaaaaaaaaaaaaa
maaaaaaaaaaYYYYYYYYYYYYYaaaaaaaaaaaaaaaaaaaaaaaaYYYYYYaaaaaaaaaaaaaaaaaaaaaaaaaaaaaaaaaaaaaaaaaaaaaaaaaaaaaaaaaaaaaaaaaaaaaaaaaaaaaYYYYYYYaaaaaaaaaaaa
maaaaaaaaaaYYYYYYYYYYYYYYYYYaaaaaaaaaaaaaaaaaaaaYYYYYYaaaaaaaaaaaaaaaaaaaaaaaaaaaaaaaaaaaaaaaaaaaaaaaaaaaaaaaaaaaaaaaaaaaaaaaaaaaaaYYaYYYYaaaaaaaaaaaa
maaaaaaaaaaYYYYYYaYYYYYYYYYYaaaaaaaaaaaaaaaaaaaaaYYYYYaaaaaaaaaaaaaaaaaaaaaaaaaaaaaaaaaaaaaaaaaaYYYYYYYaaaaaaaaaaaaaaaaaaaaaaaaaaaaaaaaYYYaaaaaaaaaaaa
maaaaaaaaaaYYaYYaaaaaaYYYaaaaaaaaaaaaaaaaaaaaaaaaaYYYaaaaaaaaaaaaaaaaaaaaaaaaaaaaaaaaaaaaaaaaaaYYYYYYYYYaaaaaaaaaaaaaaaaaaaaaaaaaaaaaaaaYYYaaaaaaaaaaa
maaaaaaaaaYYYaYYaaaaaaaYYaaaaaaaaaaaaaaaaaaaaaaaaaYYYaaaaaaaaaaaaaaaaaaaaaaaaaaaaaaaaaaaaaaaaaaaYYYYYYYYYYaaaaaaaaaaaaaaaaaaaaaaaaaaaaaaYYYaaaaaaaaaaa
maaaaaaaaaYYYaYaaaaaaaaaaaaaaaaaaaaaaaaaaaaaaaaaaYYYYaaaaaaaaaaaaaaaaaaaaaaaaaaaaaaaaaaaaaaaaaaaaaaaaaYYYYYYaaaaaaaaaaaaaaaaaaaaaaaaaaaaYYYaaaaaaaaaaa
maaaaaaaaaYYYaaaaaaaaaaaaaaaaaaaaaaaaaaaaaaaaaaaaaYYYaaaaaaaaaaaaaaaaaaaaaaaaaaaaaaaaaaaaaaaaaaaaaaaaaaaYYYYYaaaaaaaaaaaaaaaaaaaaaaaaaaaYYYaaaaaaaaaaa
maaaaaaaaaYYYaaaaaaaaaaaaaaaaaaaaaaaaaaaaaaaaaaaaaYYYaaaaaaaaaaaaaaaaaaaaaaaaaaaaaaaaaaaaaaaaaaaaaaaaaaaaYYYYYYaaaaaaaaaaaaaaaaaaaaaaaaaYYYaaaaaaaaaaa
maaaaaaaaaaYYaaaaaaaaaaaaaaaaaaaaaaaaaaaaaaaaaaaaaYYYaaaaaaaaaaaaaaaaaaaaaaaaaaaaaaaaaaaaaaaaaaaaaaaaaaaaaYYYYYYaaaaaaaaaaaaaaaaaaaaaaaaYYYaaaaaaaaaaa
maaaaaaaaaaYYYaaaaaaaaaaaaaaaaaaaaaaaaaaaaaaaaaaaaYYYaaaaaaaaaaaaaaaaaaaaaaaaaaaaaaaaaaaaaaaaaaaaaaaaaaaaaaaYYYYYaaaaaaaaaaaaaaaaaaaaaaaYYYaaaaaaaaaaa
maaaaaaaaaYYYYYaaaaaaaaaaaaaaaaaaaaaaaaaaaaaaaaaaaYYYaaaaaaaaaaaaaaaaaaaaaaaaaaaaaaaaaaaaaaaaaaaaaaaaaaaaaaaaYYYYYYaaaaaaaaaaaaaaaaaaaaaYYYaaaaaaaaaaa
maaaaaaaaYYYYYYYYYaaaaaaaaaaaaaaaaaaaaaaaaaaaaaaaaYYYaaaaaaaaaaaaaaaaaaaaaaaaaaaaaaaaaaaaaaaaaaaaaaaaaaaaaaaaaYYYYYaaaaaaaaaaaaaaaaaaaaaYYYaaaaaaaaaaa
maaaaaaaYYYYYYYYYYYYYYYYYYYaaaaaaaaaaaaaaaaaaaaaaaYYYaaaaaaaaaaaaaaaaaaaaaaaaaaaaaaaaaaaaaaaaaaaaaaaaaaaaaaaaaaYYYYYaaaaaaaaaaaaaaaaaaaYYYYaaaaaaaaaaa
maaaaaaaYYYYYYYYYYYYYYYYYYYYYaaaaaaaaaaaaaaaaaaaaYYYYaaaaaaaaaaaaaaaaaaaaaaaaaaaaaaaaaaaaaaaaaaaaaaaaaaaaaaaaaaaYYYYaaaaaaaaaaaaaaaaaaaYYYaaaaaaaaaaaa
maaaaaaaaYYYYYYYYYYYYYYYYYYYYYaaaaaaaaaaaaaaaaaaaYYYYaaaaaaaaaaaaaaaaaaaaaaaaaaaaaaaaaaaaaaaaaaaaaaaaaaaaaaaaaaaaYYYYaaaaaaaaaaaaaaaaaYYYYaaaaaaaaaaaa
maaaaaaaaaYYYYYaaaaaaaaaaYYYYYYYaaaaaaaaaaaaaaaaaYYYaaaaaaaaaaaaaaaaaaaaaaaaaaaaaaaaaaaaaaaaaaaaaaaaaaaaaaaaaaaaaaYYYaaaaaaaaaaaaaaaaaYYYaaaaaaaaaaaaa
maaaaaaaaYYYYaaaaaaaaaaaaaaaYYYYYaYaYYYaaaaaaaaaYYYYaaaaaaaaaaaaaaaaaaaaaaaaaaaaaaaaaaaaaaaaaaaaaaaaaaaaaaaaaaaaaaYYYaaaaaaaaaaaaaaaaYYYYaaaaaaaaaaaaa
maaaaaaaaYYYaaaaaaaaaaaaaaaaaaYYYYYYYYYYaaaaaaaaYYYYYaaaaaaaaaaaaaaaaaaaaaaaaaaaaaaaaaaaaaaaaaaaaaaaaaaaaaaaaaaaaaaYYYaaaaaaaaaaaaaaYYYYaaaaaaaaaaaaaa
maaaaaaaaYYYaaaammmmmmmaaaaaaaaYYYYYYYYYaaaaaaaaaYYYYYaaaaaaaaaaaaaaaaaaaaaaaaaaaaaaaaaaaaaaaaaaaaaaaaaaaaaaaaaaaaaYYYYaaaaaaaaaaaaaYYYaaaaaaaaaaaaaaa
maaaaaaaaYYYaaaamaaaaammaaaaaaaYYYYYYYYYYaaaaaaaaaYYYYaaaaaaaaaaaaaaaaaaaaaaaaaaaaaaaaaaaaaaaaaaaaaaaaaaaaaaaaaaaaaaYYYYYYYaaaaaaaaaYYYaaaaaaaaaaaaaaa
maaaaaaaYYYYaaaamaaaaaaamaaaaaaYYYYYYYYYaaaaaaaaaaaYYYaaaaaaaaaaaaaaaaaaaaaaaaaaaaaaaaaaaaaaaaaaaaaaaaaaaaaaaaaaaaaaYYYYYYYYYaaaaaaaYYaaaaaaaaaaaaaaaa
maaaaaaaYYYaaaaamaaaaaaammaaaaaYYYYYYYYYYaaaaaaaaaaYYYaaaaaaaaaaaaaaaaaaaaaaaaaaaaaaaaaaaaaaaaaaaaaaaaaaaaaaaaaaaaaaYYYYYYYYYYaaaaaaYYaaaaaaaaaaaaaaaa
maaaaaaaYYYaaaaamaaaaaaaamaaaaYYYYYYYYYYYaaaaaaaaaaYYYYaaaaaaaaaaaaaaaaaaaaaaaaaaaaaaaaaaaaaaaaaaaaaaaaaaaaaaaaaaaaaYYYYYYYYYYYYYaaaYYYaaaaaaaaaaaaaaa
maaaaaaaYYYaaaaamaaaaaaaammaaaYYYYYYYYYYYaaaaaaaaaaaYYYaaaaaaaaaaaaaaaaaaaaaaaaaaaaaaaaaaaaaaaaaaaaaaaaaaaaaaaaaaaaYYYYYaaaaYYYYYYYaYYYaaaaaaaaaaaaaaa
maaaaaaYYYaaaaaamaaaaaaaaamaaaYYYYYYYYYYaaaaaammaaaaYYYaaYYYYYYYYYYYYYYaaaaaaaaaaaaaaaaaaaaaaaaaaaaaaaaaaaaaaaaaaaYYYYYaaaaaaYYYYYYYYYYaaaaaaaaaaaaaaa
maaaaaaaYYaaaaaammaaaaaaaammaaaaYYYYYYYaaaaaammaaaaaYYYYYYYYYYYYYYYYYYYYYaaaaaaaaaaaaaaaaaaaaaaaaaaaaaaaaaaaaaaaaYYYYaaaaaaaaaaYYYYYYYYaaaaaaaaaaaaaaa
maaaaaaYYYaaaaaaamaaaaaaaaammaaaaYYYYYaaaaaammaaaaaaYYYYYYYYYYYYYYYYYYYYYYYaaaaaaaaaaaaaaaaaaaaaaaaaaaaaaaaaaaYYYYYYaaaaaaaaaaaaaaYYYYYaaaaaaaaaaaaaaa
maaaaaaaYYYaaaaaammaaaaaaaaammaaaaYYYYaaaaammaaaaaaYYYYYaaaaaaaaaaaaYYYYYYYYaaaaaaaaaaaaaaaaaaaaaaaaaaaaaaaaYYYYYYaaaaaaaaaaaaaaaaaaYYYaaaaaaaaaaaaaaa
maaaaaaaYYYYaaaaaamaaaaaaaaaamaaaaaYYaaaaammaaaaaaYYYYaaaaaaaaaaaaaaaaYYYYYYYaaaaaaaaaaaaaaaaaYYaaaaaaaaaaaYYYYYYaaaaaaaaaaaaaaaaaaaaaaaaaaaaaaaaaaaaa
maaaaaaaaYYYYaaaaammaaaaaaaaammaaaaaaaaaammaaaaaYYYYYaaaaaaaaaaaaaaaaaaaYYYYYaaaaaaaaaaaaaaaaaYYYaaaaaaaaYYYYYYYaaaaaaaaaaaaaaaaaaaaaaaaaaaaaaaaaaaaaa
maaaaaaaaYYYaaaaaaamaaaaaaaaaammaaaaaaaammaaaaaYYYYYaaaaaaaaaaaaaaaaaaaaaYYYYYaaaaaaaaaaaaaaaaaYYYaaaaaaYYYYYYYaaaaaaaaaaaaaaaaaaaaaaaaaaaaaaaaaaaaaaa
maaaaaaaaaYYYaaaaaamaaaaaaaaaaamaaaaaaammaaaaaYYYYYaaaaaaaaaaaaaaaaaaaaaaaYYYYaaaaaaaaaaaaaaaaaaYYYYYaaYYYYYaaaaaaaaaaaaaaaaaaaaaaaaaaaaaaaaaaaaaaaaaa
maaaaaaaaYYYYYYaaaamaaaaaaaaaaammaaaaammaaaaaYYYYaaaaaaaaaaaaaaaaaaaaaYYYYYYYYaaaaaaaaaaaaaaaaaaYYYYYYYYYYYaaaaaaaaaaaaaaaaaaaaaaaaaaaaaaaaaaaaaaaaaaa
maaaaaaaaYYYYYYaaaammaaaaaaaaaaammmammmaaaaaYYYYYaaaaaaaaaaaaaaaaaaaaYYYYYYYYYaaaaaaaaaaaaaaaaaaaYYYYYYYYYaaaaaaaaaaaaaaaaaaaaaaaaaaaaaaaaaaaaaaaaaaaa
maaaaaaaaaaYYYYaaaaamaaaaaaaaaaaaammmaaaaaaYYYYYaaaaaaaaaaaaaaaaaaaaYYYYYYYYYYaaaaaaaaaaaaaaaaaaaaYYYYYYYaaaaaaaaaaaaaaaaaaaaaaaaaaaaaaaaaaaaaaaaaaaaa
maaaaaaaaaaaYYYaaaaamaaaaaaaaaaaaammaaaaaYYYYYaaaaaaaaaaaaaaaaaaaaaYYYYYYaaYYaaaaaaaaaaaaaaaaaaaaaaYYYYYYaaaaaaaaaaaaaaaaaaaaaaaaaaaaaaaaaaaaaaaaaaaaa
maaaaaaaaaaYYYYaaaaamaaaaaaaaaaaammaaaaaYYYYYaaaaaaaaaaaaaaaaaaaaaaYYYYYYYaaaaaaaaaaaaaaaaaaaaaaaaaYYYYYYaaaaaaaaaaaaaaaaaaaaaaaaaaaaaaaaaaaaaaaaaaaaa
maaaaaaaaaEEYYEEaaaamaaaaaaaaaaammaaaaaaYYYYYYYYYaaaaaaaaaaaaaaaaaaYYYYYYYYaaaaaaaaaaaaaaaaaaaaaaaaaYYYYYaaaaaaaaaaaaaaaaaaaaaaaaaaaaaaaaaaaaaaaaaaaaa
maaaaaaaEEEYYYYEaaaamaaaaaaaaaaamaaaaaaYYYYYYYYYYYYYaaaaaaaaaaaaaaaYYYYYYYYYaaaaaaaaaaaaaaaaaaaaaaaaYYYYYaaaaaaaaaaaaaaaaaaaaaaaaaaaaaaaaaaaaaaaaaaaaa
maaaaaaaEEYYYYEEaaaamaaaaaaaaaammaaaaaYYYYYYYYYYYYYYYYaaaaaaaaaaaaaaYYYYYYYYaaaaaaaaaaaaaaaaaaaaaaaaaYYYYaaaaaaaaaaaaaaaaaaaaaaaaaaaaaaaaaaaaaaaaaaaaa
maaaaaaaEYYYYYEEEaaamaaaaaaaaaamaaaaaYYYYYYYaaYYYYYYYYYaaaaaaaaaaaaYYYYYYYYYaaaaaaaaaaaaaaaaaaaaaaaaaaYYYaaaaaaaaaaaaaaaaaaaaaaaaaaaaaaaaaaaaaaaaaaaaa
maaaaaaaEEYYYYYYEaaamaaaaaaaaaamaaaaYYYYYYYaaaaYYYYYYYYYaaaaaaaaaaaaaYYYYYYYaaaaaaaaaaaaaaaaaaaaaaaaaaYYYaaaaaaaaaaaaaaaaaaaaaaaaaaaaaaaaaaaaaaaaaaaaa
maaaaaaaEEYYYYEEEaaamaaaaaaaaammaaaaYYYYYYaaaaaaYYYYYYYYYaaaaaaaaaaaaaYYYYYYYaaaaaaaaaaaaaaaaaaaaaaaaaYYYaaaaaaaaaaaaaaYYYYYYYYaaaaaaaaaaaaaaaaaaaaaaa
maaaaaaaEYYYYYEaaaaamaaaaaaaaamaaaaaYYYYYaaaaaaaaYYYYYYYYYaaaaaaaaaaaaaaaaaaaaaaaaaaaaaaaaaaaaaaaaaaaaYYYaaaaaaaaaaaaaYYYYYYYYYYYaaaaaaaaaaaaaaaaaaaaa
maaaaaaEEYYYYYEaaaamaaaaaaaaammaaaaaYYYYYaaaaaaaaaYYYYYYYYYaaaaaaaaaaaaaaaaaaaaaaaaaaaaaaaaaaaaaaaaaaaYYYaaaaaaaaaaaaaYYYYYYYYYYYYaaaaaaaaaaaaaaaaaaaa
maaaaaaEYYYYYYEaaaamaaaaaaaaamaaaaaaYYYYaaaaaaaaaaaaaYYYYYYYaaaaaaaaaaaaaaaaaaaaaaaaaaaaaaaaaaaaaaaaaaYYYaaaaaaaaaaaaYYYYYYYYYYYYYYaaaaaaaaaaaaaaaaaaa
maaaaaaEEYYYYEEaaaamaaaaaaaaamaaaaaYYYYYaaaaaaaaaaaaaaYYYYYYYaaaaaaaaaaaaaaaaaaaaaaaaaaaaaaaaaaaaaaaaYYYYaaaaaaaaaaaYYYYYYYYYYYYYYYaaaaaaaaaaaaaaaaaaa
maaaaaaEEYYYYEaaaamaaaaaaaaaamaaaaaYYYYEaaaaaaaaaaaaaaaYYYYYYYYYaaaaaaaaaaaaaaaaaaaaaaaaaaaaaaaaaaaaaYYYaaaaaaaaaaaYYYYYYYYYYYYYYYYaaaaaaaaaaaaaaaaaaa
maaaaaaEYYYYYEaaaamaaaaaaaaaamaaaaaYYYYEaaaaaaaaaaaaaaaaYYYYYYYYYYaaaaaaaaaaaaaaaaaaaaaaaaaaaaaaaaaaYYYYaaaaaaaaaaYYYYYYYYYYYYYYYYYaaaaaaaaaaaaaaaaaaa
maaaaaaEEEYYYEaaammaaaaaaaaaamaaaEEEYYYEaaaaaaaaaaaaaaaaaYYYYYYYYYYYYYYaaaaaaaaaYYYYYaaaaaaaaaaaaaaaYYYYaaaaaaaaaYYYYYYYYYYYYYYYYYYaaaaaaaaaaaaaaaaaaa
maaaaaaaaEYYYEaaamaaaaaaaaammmaaaEYYYYYEaaaaamaaaaaaaaaaaaYYYYYYYYYYYYYYYYaaaaYYYYYYYYYYaYYaaaaaaaaYYYYYaaaaaaaaaYYYYYYYYYYYYYYYYYYaaaaaaaaaaaaaaaaaaa
maaaaaaaaEYYYEaaammmmmmmmmmmaaaaaEYYYYYEaaaaamaaaaaaaaaaaaaYYYYYYYYYYYYYYaaaaYYYYYYYYYYYYYYYYaaaaaYYYYYaaaaaaaaaYYYYYYYYYYYYYYYYYYYaaaaaaaaaaaaaaaaaaa
maaaaaaaaEYYYEaaaaaaaaaaaaaaaaaaEEYYYYYEaaaaammaaaaaaaaaaaaaaYYYYYYYYYYYYaaaYYYYYYYYYYYYYYYYYYYYaaYYYYYaaaaaaaYYYYYYYYYYYYYYYYYYYYYaaaaaaaaaaaaaaaaaaa
maaaaaaaaEYYYEEaaaaaaaEEEEEEEaaaEYYYYYYEaaaaaammaaaaaaaaaaaaaaaYYYYYYYYYYYYYYYYYYYYYYYYYYYYYYYYYYYYYYYYYYYYYYYYYYYYYYYYYYYYYYYYYYYYaaaaaaaaaaaaaaaaaaa
maaaaaaaaEYYYEEaaaaaEEEYYYYYEEEEEYYYYYYEaaaaaaammaaaaaaaaaaaaaaaaaaYYYYYYYYYYYYYYYYYYYYYYYYYYYYYYYYYYYYYYYYYYYYYYYYYYYYYYYYYYYYYYYYaaaaaaaaaaaaaaaaaaa
maaaaaaaEEYYYYEaaaEEEYYYYYYYYYYYYYYYYYYEaaaaaaaammaaaaaaaaaaaaaaaaaaaaaaYYYYYYYaaaaaaaaaaYYYYaaaaaaaaaaaaaaaaaaYYYYYYYYYYYYYYYYYYYYaaaaaaaaaaaaaaaaaaa
maaaaaaaEYYYYYEaEEEYYYYYYYYYYYYYYYYYYYYEaaaaaaaaammaaaaaaaaaaaaaaaaaaaaaYYYYaaaaaaaaaaaaaaYYYYaaaaaaaaaaaaaaaaaaaaYYYYYYYYYYYYYYYYYaaaaaaaYaaaaaaaaaaa
maaaaaaaEYYYYYEEEYYYYYYYYYYYYYYYYYYYYYYEEaaaaaaaaammaaaaaaaaaaaaaaaaaaaaYYYYaaaaaaaaaaaaaaaYYYaaaaaaaaaaaaaaaaaaaaaYYYYYYYYYYYYYYYaaaaaaaYYYaaaaaaaaaa
maaaaaaaEEYYYYEYYYYYYYYYYEYYYYYYYYYYYYYYEEaaaaaaaaammaaaaaaaaaaaaaaaaaaYYYYYaaaaaaaaaaaaaaaYYYaaaaaaaaaaaaaaaaaaaaaaYYYYYYYYYYYYYaaaaaaaaYYYYaaaaaaaaa
maaaaaaaEEYYYYYYYYYYYYYYEEEEYYYYEYYYYYYYYEEaaaaaaaaammaaaaaaaaaaaaaaaaYYYYYYaaaaaaaaaaaaaaaYYYaaaaaaaaaaaYYaaaaaaaaaYYYYYYYYYYYYaaaaaaaaaYYYYYaaaaaaaa
maaaaaaEEEYYYYYYYYYEEEEEEEEEEEEEEEEEYYYYYYEEaaaaaaaaamaaaaaaaaaaaaaaaaYYYYYaaaaaaaaaaaaaaaaaYYaaaaaaaaaaaYYYYaaaaaaaYYYYYYYYYYYaaaaaaaaaaYYYYYYaaaaaaa
maaaaaaEEYYYYYYYYYEEaaaaaaaaaaaaaaaEYYYYYYYEaaaaaaaaamaaaaaaaaaaaaaaaaaYYYaaaaaaaaaaaaaaaaaaYYYaaaaaaaaaaaaYYYaaaaaaaYYYYYYYYaaaaaaaaaaaaYYYYYYaaaaaaa
maaaaaaEYYYYYYYYYEEaaaaaaaaaaaaaaaaEEEYYYYYEEaaaaaaaammaaaaaaaaaaaaaaaYYYaaaaaaaaaaaaaaaaaaaYYYaaaaaaaaaaaaaYYaaaaaaaaaaaaaaaaaaaaaaaaaaaYYYYYYaaaaaaa
maaaaaaEYYYYYYYEEEaaaaaaaaaaaaaaaaaaaEEEYYYYEEEaaaaaaamaaaaaaaaaaaaaaYYYYaaaaaaaaaaaaaaaaaaaYYYYaaaaaaaaaaaaYYaaaaaaaaaaaaaaaaaaaaaaaaaaaYYYYYYaaaaaaa
maaaaaEEYYYYYEEEaaaaaaaaaaaaaaaaaaaaaaaEEEYYYYEaaaaaaamaaaaaaaaaaaaaYYYYaaaaaaaaaaaaaaaaaaaaaYYYaaaaaaaaaaaaYYYaaaaaaaaaaaaaaaaaaaaaaaaaaYYYYYYaaaaaaa
maaaaaEYYYYYYEaaaaaaaaaaaaaaaaaaaaaaaaaaaEYYYYEaaaaaaammaaaaaaaaaaaYYYYYaaaaaaaaaaaaaaaaaaaaaYYYaaaaaaaaaaaaYYYaaaaaaaaaaaaaaaaaaaaaaaaaaaYYYYYaaaaaaa
maaaaaEEYYYYYEaaaaaaaaaaaaaaaaaaaaaaaaaaaEEYYYEEaaaaaaamaaaaaaaaaaaaYYYaaaaaaaaaaaaaaaaaaaaaaYYYYaaaaaaaaaaYYYYaaaaaaaaaaaaaaaaaaaaaaaaaaaYYYYYaaaaaaa
maaaaaaEYYYYYEaaaaaaaaaaaaaaaaaaaaaaaaaaaaEEYYYEaaaaaaamaaaaaaaaaaaYYYaaaaaaaaaaaaaaaaaaaaaaaaYYYYaaaaaaaaYYYaaaaaaaaaaaaaaaaaaaaaaaaaaaaaYYYYYaaaaaaa
maaaaaaEEEYYYEaaammmmmmmmmmmmmmmmmmmmmaaaaaEYYYEEaaaaaamaaaaaaaaaaYYYYaaaaaaaaaaaaaaaaaaaaaaaaYYYYaaaaaaaaYYaaaaaaaaaaaaaaaaaaaaaaaaaaaaaaYYYYYaaaaaaa
maaaaaaaaEYYYEaaamaaaaaaaaaaaaaaaaaaamaaaaaEYYYYEaaaaaamaaaaaaaaaYYYYYaaaaaaaaaaaaaaaaaaaaaaaaaYYYaaaaaaaYYYaaaaaaaaaaaaaaaaaaaaaaaaaaaaaaYYYYYaaaaaaa
maaaaaaaEEYYYEaaamaaaaaaaaaaaaaaaaaaamaaaaaEEYYYEaaaaaamaaaaaaaaYYYYYaaaaaaaaaaaaaaaaaaaaaaaaaaYYYYaaaaYYYYaaaaaaaaaaaaaaaaaaaaaaaaaaaaaaYYYYYYaaaaaaa
maaaaaaEEYYYYEaaamaaaaaaaaaaaaaaaaaaamaaaaaaEEYYEaaaaaamaaaaaaaYYYYYYaaaaaaaaaaaaaaaaaaaaaaaaaaaaYYYaYYYYYaaaaaaaaaaaaaaaaaaaaaaaaaaaaaaaYYYYYYaaaaaaa
maaaaaEEYYYYYEaaamaaaaaaaaaaaaaaaaaaamaaaaaEEYYEEaaaaaamaaaaaaaaYYYYaaaaaaaaaaaaaaaaaaaaaaaaaaaaaYYYYYYYYaaaaaaaaaaaaaaaaaaaaaaaaaaaaaaaaYYYYYYaaaaaaa
maaaaEEYYYYYYEaaamaaaaaaaaaaaaaaaaaaamaaaaaEYYYEaaaaaaamaaaaaaaYYYYaaaaaaaaaaaaaaaaaaaaaaaaaaaaaaaYYYYYaaaaaaaaaaaaaaaaaaaaaaaaaaaaaaaaaaYYYYYaaaaaaaa
maaaEEYYYYYYYEaaamaaaaaaaaaaaaaaaaaaamaaaaaYYYaaaaaaaaamaaaaaaaYYYaaaaaaaaaaaaaaaaaaaaaaaaaaaaaaaaaYYYYYaaaaaaaaaaaaaaaaaaaaaaaaaaaaaaaaYYYYYYaaaaaaaa
maaaEYYYYYYEEEaaamaammmmmmmmmmmmmmmmmmaaaaaYYYaaaaaaaaamaaaaaaaYYYaaaaaaaaaaaaaaaaaaaaaaaaaaaaaaaaaaYYYYYYYaaaaaaaaaaaaaaaaaaaaaaaaaaaaaYYYYYaaaaaaaaa
maaEEYYYkYYEaaaammaamaaaaaaaaaaaaaaaaaaaaaYYYYaaaaaaaaamaaaaaaaYYYaaaaaaaaaaaaaaaaaaaaaaaaaaaaaaaaaaaaYYYYYYaaaaaaaaaaaaaaaaaaaaaaaaaaaaYYYYYaaaaaaaaa
maEEYYYYYYYEaaaamaaamaaaaaaaaaaaaaaaaaaaaYYYYaaaaaaaaaamaaaaaaaYYYYaaaaaaaaaaaaaaaaaaaaaaaaaaaaaaaaaaaaYYYYYYYYaaaaaaaaaaaYYaYYYaaaaaaaaYYYYYaaaaaaaaa
maEEYYYYYYYEaaammaaamaaaaaaaaaaaaaaaaaaaYYYYaaaaaaaaaaamaaaaaaaYYYYaaaaaaaaaaaaaaaaaaaaaaaaaaaaaaaaaaaaaaYYYYYYYaaaaaaaaaYYYYYYYYYaaaaaaYYYYaaaaaaaaaa
maEEYYYYYYYEEammaaaamaaaaYaaaaaaaaaaaaaaYYYaaaaaaaaaaammaaaaaaaYYYYaaaaaaaaaaaaaaaaaaaaaaaaaaaaaaaaaaaaaaaaaYYYYYaaaaaaaYYYYaaaYYYYaaaaaYYYYaaaaaaaaaa
maEZZZeQeeZZEamaaaaamaaaaYYaaaaaaaaaaaaYYaaaaaaaaaaaaamaaaaaaaaaYYYYaaaaaaaaaaaaaaaaaaaaaaaaaaaaaaaaaaaaaaaaaYYYYaaaaaaaaaaYaaaYYYYaaaaYYYYaaaaaaaaaaa
maEeMMMzMxxZEamaaaaamaaaYYYaaaaaaaaaaYYYaaaaaaaaaaaaaamaaaaaaaaaYYYYYYYYaaaaaaaaaaaaaaaaaaaaaaaaaaaaaaaaaaaaaaaaaaaaaaaaaaaaaaaaYYYYaaYYYYYaaaaaaaaaaa
maEZMMMVRpCZEamaaaaamaaaYYYaaaaaaaaaYYYaaaaaaaaaaaaaaamaaaaaaaaaaYYYYYYYYaaaaaaaaaaaaaaaaaaaaaaaaaaaaaaaaaaaaaaaaaaaaaaaaaaaaaaaaYYYYYYYYaaaaaaaaaaaaa
maEZTMMMMLMeEamaaaaamaaYYYYYaaaaaaaYYYYaaaaaaaaaaaaaaamaaaaaaaaaaaaYYYYYYaaaaaaaaaaaaaaaaaaaaaaaaaaaaaaaaaaaaaaaaaaaaaaaaaaaaaaaaaYYYYYYYaaaaaaaaaaaaa
mEEZTMMMMzMZEEmaaaaamaaYYYYYaaaaaaYYYYYaaaaaaaaaaaaaaamaaaaaaaaaaaaaaYYYYYYYaaaaaaaaaaaaaaaaaaaaaaaaaaaaaaaaaaaaaaaaaaaaaaaaaaaaaaaYYYYYaaaaaaaaaaaaaa
mEEZTyMMMlMeEEmaaaaamaaaYYYYaaaaYYYYYYaaaaaaaaaaaaaaaamaaaaaaaaaaaaaaaYYYYYYYYYaaaaaaaaaaaaaaaaaaaaaaaaaaaaaaaaaaaaaaaaaaaaaaaaaaaYYYYYaaaaaaaaaaaaaaa
mEEeTMMMMzMZEEmaaaaamaaaaYYYaYYYYYYYaaaaaaaaaaaaaaaaaamaaaaaaaaaaaaaaaaaYYYYYYYYYYaaaaaaaaaaaaaaaaaaaaaaaaaaaaaYYYYYYYYaaaaaaaaaaYYYYYaaaaaaaaaaaaaaaa
mEEZMMMMMzMZEEmaaaaamaaaaYYYYYYYYYaaaaaaaaaaaaaaaaaammmaaaaaaaaaaaaaaaaaaaaYYYYYYYYYYaaaaaaaaaaaaaaaaaaYYYYYaYYYYYYYYYYYaaaaaaaYYYYYYaaaaaaaaaaaaaaaaa
mEEZMMMIMzMZEEmaaaaamaaaaaYYYYYYYaaaaaaaaaaaaaaaaaaamaaaaaaaaaaaaaaaaaaaaaaaaaYYYYYYYYYYYYYaaaaaaaaaaaYYYYYYYYYYYaaaaYYYYaYYaYYYYYYYaaaaaaaaaaaaaaaaaa
mEEeFUMMMLMeEEmaaaaamaaaaaaYYYYYaaaaaaaaaammmmmmmmmmmaaaaaaaaaaaaaaaaaaaaaaaaaaaaaaaYYYYYYYYYYYYYaaaaYYYYYYYYYYaaaaaaYYYYYYYYYYYYYaaaaaaaaaaaaaaaaaaaa
mEEZXdddddoZEEmaaaaamaaaaaaaaaaaaaaaaaaaaamaaaaaaaaaaaaaaaaaaaaaaaaaaaaaaaaaaaaaaaaaaaaaaYYYYYYYYYYYYYYYYYaaaaaaaaaaaYYYYYYYYYYYYaaaaaaaaaaaaaaaaaaaaa
mEEZeZeZZeeZEEmaaaaamaaaaaaaaaaaaaaaaaaaaamaaaaaaaaaaaaaaaaaaaaaaaaaaaaaaaaaaaaaaaaaaaaaaaaaYYYYYYYYYYYYYaaaaaaaaaaaaYYYYYYYYYaaaaaaaaaaaaaaaaaaaaaaaa
mEEEEEEEEEEEEEmaaaaammmmmmmmmmmmmmmmmmmmmmmaaaaaaaaaaaaaaaaaaaaaaaaaaaaaaaaaaaaaaaaaaaaaaaaaaaaaaaaaaaaaaaaaaaaaaaaaaaaaaaaaaaaaaaaaaaaaaaaaaaaaaaaaaa
mEEEEEEEEEEEEEmaaaaaaaaaaaaaaaaaaaaaaaaaaaaaaaaaaaaaaaaaaaaaaaaaaaaaaaaaaaaaaaaaaaaaaaaaaaaaaaaaaaaaaaaaaaaaaaaaaaaaaaaaaaaaaaaaaaaaaaaaaaaaaaaaaaaaaa
mmmmmmmmmmmmmmmaaaaaaaaaaaaaaaaaaaaaaaaaaaaaaaaaaaaaaaaaaaaaaaaaaaaaaaaaaaaaaaaaaaaaaaaaaaaaaaaaaaaaaaaaaaaaaaaaaaaaaaaaaaaaaaaaaaaaaaaaaaaaaaaaaaaaaa
"}
