"a" = (/turf/open/space/basic,/area/space)
"d" = (/obj/effect/decal/cleanable/blood/footprints{dir = 4},/turf/open/floor/plating,/area/space)
"e" = (/turf/closed/wall/rust,/area/space)
"k" = (/turf/open/floor/plating,/area/space)
"l" = (/obj/machinery/portable_atmospherics/canister/oxygen,/obj/effect/decal/cleanable/blood/footprints{dir = 1},/turf/open/floor/plating,/area/space)
"m" = (/turf/closed/indestructible/rock,/area/space)
"o" = (/obj/machinery/vending/boozeomat/all_access,/turf/open/floor/plating,/area/space)
"p" = (/obj/effect/decal/cleanable/blood/footprints{dir = 1},/obj/effect/decal/cleanable/blood/footprints{dir = 8},/turf/open/floor/plating,/area/space)
"x" = (/obj/structure/table,/turf/open/floor/plating,/area/space)
"y" = (/obj/effect/decal/cleanable/oil/slippery,/turf/open/floor/plating,/area/space)
"z" = (/obj/effect/decal/cleanable/blood/footprints{dir = 1},/turf/open/floor/plating,/area/space)
"C" = (/obj/structure/table,/obj/item/kinetic_crusher{pixel_x = -5},/obj/item/kinetic_crusher{pixel_x = 5},/obj/item/kinetic_crusher,/turf/open/floor/plating,/area/space)
"E" = (/turf/closed/mineral,/area/space)
"F" = (/obj/structure/table/wood,/turf/open/floor/plating,/area/space)
"I" = (/obj/machinery/gateway/away,/turf/open/floor/plating,/area/space)
"L" = (/obj/effect/decal/cleanable/oil/slippery,/obj/effect/decal/cleanable/oil,/obj/effect/decal/cleanable/blood/footprints{dir = 1},/turf/open/floor/plating,/area/space)
"M" = (/obj/effect/landmark/latejoin,/turf/open/misc/asteroid,/area/space)
"Q" = (/obj/machinery/door/airlock/external/ruin{welded = 1},/turf/open/floor/plating,/area/space)
"R" = (/obj/effect/decal/cleanable/blood/footprints{dir = 8},/turf/open/floor/plating,/area/space)
"T" = (/obj/structure/table,/obj/item/pickaxe{pixel_x = -5},/obj/item/gun/energy/recharge/kinetic_accelerator,/turf/open/floor/plating,/area/space)
"U" = (/obj/structure/table/wood,/obj/item/flashlight/lantern,/turf/open/floor/plating,/area/space)
"V" = (/obj/effect/decal/cleanable/blood/footprints{dir = 8},/obj/effect/decal/cleanable/blood/footprints{dir = 1},/turf/open/floor/plating,/area/space)
"X" = (/obj/item/chair,/obj/effect/decal/cleanable/blood,/obj/effect/decal/cleanable/blood/gibs/old,/turf/open/floor/plating,/area/space)
"Y" = (/turf/open/misc/asteroid,/area/space)
"Z" = (/turf/closed/wall,/area/space)

(1,1,1) = {"
aaaaaaaaaaaaaaaaaaaaaaaaaaaaaaaaaaaaaaaaaaaaaaaaaaaaaaaaaaaaaaaaaaaaaaaaaaaaaaaaaaaaaaaaaaaaaaaaaaaaaaaaaaaaaaaaaaaaaaaaaaaaaaaaaaaaaaaaaaaaaaaaaaaaaa
aaaaaaaaaaaaaaaaaaaaaaaaaaaaaaaaaaaaaaaaaaaaaaaaaaaaaaaaaaaaaaaaaaaaaaaaaaaaaaaaaaaaaaaaaaaaaaaaaaaaaaaaaaaaaaaaaaaaaaaaaaaaaaaaaaaaaaaaaaaaaaaaaaaaaa
aaaaaaaaaaaaaaaaaaaaaaaaaaaaaaaaaaaaaaaaaaaaaaaaaaaaaaaaaaaaaaaaaaaaaaaaaaaaaaaaaaaaaaaaaaaaaaaaaaaaaaaaaaaaaaaaaaaaaaaaaaaaaaaaaaaaaaaaaaaaaaaaaaaaaa
aaaaaaaaaaaaaaaaaaaaaaaaaaaaaaaaaaaaaaaaaaaaaaaaaaaaaaaaaaaaaaaaaaaaaaaaaaaaaaaaaaaaaaaaaaaaaaaaaaaaaaaaaaaaaaaaaaaaaaaaaaaaaaaaaaaaaaaaaaaaaaaaaaaaaa
aaaaaaaaaaaaaaaaaaaaaaaaaaaaaaaaaaaaaaaaaaaaaaaaaaaaaaaaaaaaaaaaaaaaaaaaaaaaaaaaaaaaaaaaaaaaaaaaaaaaaaaaaaaaaaaaaaaaaaaaaaaaaaaaaaaaaaaaaaaaaaaaaaaaaa
aaaaaaaaaaaaaaaaaaaaaaaaaaaaaaaaaaaaaaaaaaaaaaaaaaaaaaaaaaaaaaaaaaaaaaaaaaaaaaaaaaaaaaaaaaaaaaaaaaaaaaaaaaaaaaaaaaaaaaaaaaaaaaaaaaaaaaaaaaaaaaaaaaaaaa
aaaaaaaaaaaaaaaaaaaaaaaaaaaaaaaaaaaaaaaaaaaaaaaaaaaaaaaaaaaaaaaaaaaaaaaaaaaaaaaaaaaaaaaaaaaaaaaaaaaaaaaaaaaaaaaaaaaaaaaaaaaaaaaaaaaaaaaaaaaaaaaaaaaaaa
aaaaaaaaaaaaaaaaaaaaaaaaaaaaaaaaaaaaaaaaaaaaaaaaaaaaaaaaaaaaaaaaaaaaaaaaaaaaaaaaaaaaaaaaaaaaaaaaaaaaaaaaaaaaaaaaaaaaaaaaaaaaaaaaaaaaaaaaaaaaaaaaaaaaaa
aaaaaaaaaaaaaaaaaaaaaaaaaaaaaaaaaaaaaaaaaaaaaaaaaaaaaaaaaaaaaaaaaaaaaaaaaaaaaaaaaaaaaaaaaaaaaaaaaaaaaaaaaaaaaaaaaaaaaaaaaaaaaaaaaaaaaaaaaaaaaaaaaaaaaa
aaaaaaaaaaaaaaaaaaaaaaaaaaaaaaaaaaaaaaaaaaaaaaaaaaaaaaaaaaaaaaaaaaaaaaaaaaaaaaaaaaaaaaaaaaaaaaaaaaaaaaaaaaaaaaaaaaaaaaaaaaaaaaaaaaaaaaaaaaaaaaaaaaaaaa
aaaaaaaaaaaaaaaaaaaaaaaaaaaaaaaaaaaaaaaaaaaaaaaaaaaaaaaaaaaaaaaaaaaaaaaaaaaaaaaaaaaaaaaaaaaaaaaaaaaaaaaaaaaaaaaaaaaaaaaaaaaaaaaaaaaaaaaaaaaaaaaaaaaaaa
aaaaaaaaaaaaaaaaaaaaaaaaaaaaaaaaaaaaaaaaaaaaaaaaaaaaaaaaaaaaaaaaaaaaaaaaaaaaaaaaaaaaaaaaaaaaaaaaaaaaaaaaaaaaaaaaaaaaaaaaaaaaaaaaaaaaaaaaaaaaaaaaaaaaaa
aaaaaaaaaaaaaaaaaaaaaaaaaaaaaaaaaaaaaaaaaaaaaaaaaaaaaaaaaaaaaaaaaaaaaaaaaaaaaaaaaaaaaaaaaaaaaaaaaaaaaaaaaaaaaaaaaaaaaaaaaaaaaaaaaaaaaaaaaaaaaaaaaaaaaa
aaaaaaaaaaaaaaaaaaaaaaaaaaaaaaaaaaaaaaaaaaaaaaaaaaaaaaaaaaaaaaaaaaaaaaaaaaaaaaaaaaaaaaaaaaaaaaaaaaaaaaaaaaaaaaaaaaaaaaaaaaaaaaaaaaaaaaaaaaaaaaaaaaaaaa
aaaaaaaaaaaaaaaaaaaaaaaaaaaaaaaaaaaaaaaaaaaaaaaaaaaaaaaaaaaaaaaaaaaaaaaaaaaaaaaaaaaaaaaaaaaaaaaaaaaaaaaaaaaaaaaaaaaaaaaaaaaaaaaaaaaaaaaaaaaaaaaaaaaaaa
aaaaaaaaaaaaaaaaaaaaaaaaaaaaaaaaaaaaaaaaaaaaaaaaaaaaaaaaaaaaaaaaaaaaaaaaaaaaaaaaaaaaaaaaaaaaaaaaaaaaaaaaaaaaaaaaaaaaaaaaaaaaaaaaaaaaaaaaaaaaaaaaaaaaaa
aaaaaaaaaaaaaaaaaaaaaaaaaaaaaaaaaaaaaaaaaaaaaaaaaaaaaaaaaaaaaaaaaaaaaaaaaaaaaaaaaaaaaaaaaaaaaaaaaaaaaaaaaaaaaaaaaaaaaaaaaaaaaaaaaaaaaaaaaaaaaaaaaaaaaa
aaaaaaaaaaaaaaaaaaaaaaaaaaaaaaaaaaaaaaaaaaaaaaaaaaaaaaaaaaaaaaaaaaaaaaaaaaaaaaaaaaaaaaaaaaaaaaaaaaaaaaaaaaaaaaaaaaaaaaaaaaaaaaaaaaaaaaaaaaaaaaaaaaaaaa
aaaaaaaaaaaaaaaaaaaaaaaaaaaaaaaaaaaaaaaaaaaaaaaaaaaaaaaaaaaaaaaaaaaaaaaaaaaaaaaaaaaaaaaaaaaaaaaaaaaaaaaaaaaaaaaaaaaaaaaaaaaaaaaaaaaaaaaaaaaaaaaaaaaaaa
aaaaaaaaaaaaaaaaaaaaaaaaaaaaaaaaaaaaaaaaaaaaaaaaaaaaaaaaaaaaaaaaaaaaaaaaaaaaaaaaaaaaaaaaaaaaaaaaaaaaaaaaaaaaaaaaaaaaaaaaaaaaaaaaaaaaaaaaaaaaaaaaaaaaaa
aaaaaaaaaaaaaaaaaaaaaaaaaaaaaaaaaaaaaaaaaaaaaaaaaaaaaaaaaaaaaaaaaaaaaaaaaaaaaaaaaaaaaaaaaaaaaaaaaaaaaaaaaaaaaaaaaaaaaaaaaaaaaaaaaaaaaaaaaaaaaaaaaaaaaa
aaaaaaaaaaaaaaaaaaaaaaaaaaaaaaaaaaaaaaaaaaaaaaaaaaaaaaaaaaaaaaaaaaaaaaaaaaaaaaaaaaaaaaaaaaaaaaaaaaaaaaaaaaaaaaaaaaaaaaaaaaaaaaaaaaaaaaaaaaaaaaaaaaaaaa
aaaaaaaaaaaaaaaaaaaaaaaaaaaaaaaaaaaaaaaaaaaaaaaaaaaaaaaaaaaaaaaaaaaaaaaaaaaaaaaaaaaaaaaaaaaaaaaaaaaaaaaaaaaaaaaaaaaaaaaaaaaaaaaaaaaaaaaaaaaaaaaaaaaaaa
aaaaaaaaaaaaaaaaaaaaaaaaaaaaaaaaaaaaaaaaaaaaaaaaaaaaaaaaaaaaaaaaaaaaaaaaaaaaaaaaaaaaaaaaaaaaaaaaaaaaaaaaaaaaaaaaaaaaaaaaaaaaaaaaaaaaaaaaaaaaaaaaaaaaaa
aaaaaaaaaaaaaaaaaaaaaaaaaaaaaaaaaaaaaaaaaaaaaaaaaaaaaaaaaaaaaaaaaaaaaaaaaaaaaaaaaaaaaaaaaaaaaaaaaaaaaaaaaaaaaaaaaaaaaaaaaaaaaaaaaaaaaaaaaaaaaaaaaaaaaa
aaaaaaaaaaaaaaaaaaaaaaaaaaaaaaaaaaaaaaaaaaaaaaaaaaaaaaaaaaaaaaaaaaaaaaaaaaaaaaaaaaaaaaaaaaaaaaaaaaaaaaaaaaaaaaaaaaaaaaaaaaaaaaaaaaaaaaaaaaaaaaaaaaaaaa
aaaaaaaaaaaaaaaaaaaaaaaaaaaaaaaaaaaaaaaaaaaaaaaaaaaaaaaaaaaaaaaaaaaaaaaaaaaaaaaaaaaaaaaaaaaaaaaaaaaaaaaaaaaaaaaaaaaaaaaEEEEaaaaaaaaaaaaaaaaaaaaaaaaaaa
aaaaaaaaaaaaaaaaaaaaaaaaaaaaaaaaaaaaaaaaaaaaaaaaaaaaaaaaaaaaaaaaaaaaaaaaaaaaaaaaaaaaaaaaaaaaaaaaaaaaaaaaaaaaaaaaaaaaaEEEYYEaaaaaaaaaaaaaaaaaaaaaaaaaaa
aaaaaaaaaaaaaaaaaaaaaaaaaaaaaaaaaaaaaaaaaaaaaaaaaaaaaaaaaaaaaaaaaaaaaaaaaaaaaaaaaaaaaaaaaaaaaaaaaaaaaaaaaaaaaaaaaaaaaEYEYYEaaaaaaaaaaaaaaaaaaaaaaaaaaa
aaaaaaaaaaaaaaaaaaaaaaaaaaaaaaaaaaaaaaaaaaaaaaaaaaaaaaaaaaaaaaaaaaaaaaaaaaaaaaaaaaaaaaaaaaaaaaaaaaaaaaaaaaaaaaaaaaaaaEYYYYEaaaaaaaaaaaaaaaaaaaaaaaaaaa
aaaaaaaaaaaaaaaaaaaaaaaaaaaaaaaaaaaaaaaaaaaaaaaaaaaaaaaaaaaaaaaaaaaaaaaaaaaaaaaaaaaaaaaaaaaaaaaaaaaaaaaaaaaaaaaaaaaaaEEYYYEaaaaaaaaaaaaaaaaaaaaaaaaaaa
aaaaaaaaaaaaaaaaaaaaaaaaaaaaaaaaaaaaaaaaaaaaaaaaaaaaaaaaaaaaaaaaaaaaaaaaaaaaaaaaaaaaaaaaaaaaaaaaaaaaaaaaaaaaaaaaaaEEEEEYYYEaaaaaaaaaaaaaaaaaaaaaaaaaaa
maaaaaaaaaaaaaaaaaaaaaaaaaaaaaaaaaaaaaaaaaaaaaaaaaaaaaaaaaaaaaaaaaaaaaaaaaaaaaaaaaaaaaaaaaaaaaaaaaaaaaaaaaaaaaaaaEEYYYYYYEEaaaaaaaaaaaaaaaaaaaaaaaaaaa
maaaaaaaaaaaaaaaaaaaaaaaaaaaaaaaaaaaaaaaaaaaaaaaaaaaaaaaaaaaaaaaaaaaaaaaaaaaaaaaaaaaaaaaaaaaaaaaaaaaaaaaaaaaaaaaaEYYYYYYYEaaaaaaaaaaaaaaaaaaaaaaaaaaaa
maaaaaaaaaaaaaaaaaaaEEEEEEEEEEEEaaaaaaaaaaaaaaaaaaaaaaaaaaaaaaaaaaaaaaaaaaaaaaaaaaaaaaaaaaaaaaaaaaaaaaaaaaaaaaaaEEYYYYYEEEaaaaaaaaaaaaaaaaaaaaaaaaaaaa
maaaaaaaaaaaaaaaaaEEEYYYYYYYYYYEEEEaaaaaaaaaaaaaaaaaaaaaaaaaaaaaaaaaaaaaaaaaaaaaaaaaaaaaaaaaaaaaaaaaaaaaaaaaaaaaEYYYYEEEaaaaaaaaaaaaaaaaaaaaaaaaaaaaaa
maaaaaaaaaaaaaaaEEEYYYYYYYYYYYYYYYEEaaaaaaaaaaaaaaaaaaaaaaaaaaaaaaaaaaaaaaaaaaaaaaaaaaaaaaaaaaaaaaaaaaaaaaaaaaaEEYYYEEaaaaaaaaaaaaaaaaaaaaaaaaaaaaaaaa
maaaaaaaaaaaaaaEEYYYYYYYYYYYYYYYYYYEEEEEaaaaaaaaaaaaaaaaaaaaaaaaaaaaaaaaaaaaaaaaaaaaaaaaaaaaaaaaaaaaaaaaaaaaaaaEYYYEEaaaaaaaaaaaaaaaaaaaaaaaaaaaaaaaaa
maaaaaaaaaaaaaaEYYYEEEEEYYYYYYYYYYYYYYYEaaaaaaaaaaaaaaaaaaaaaaaaaaaaaaaaaaaaaaaaaaaaaaaaaaaaaaaaaaaaaaaaaaaaaaEEYYYEaaaaaaaaaaaaaaaaaaaaaaaaaaaaaaaaaa
maaaaaaaaaaaaaaEYEEEaaaEEEEEEEYYYYYYYYYEaaaaaaaaaaaaaaaaaaaaaaaaaaaaaaaaaaaaaaaaaaaaaaaaaaaaaaaaaaaaaaaaaaaaaaEYYYYEaaaaaaaaaaaaaaaaaaaaaaaaaaaaaaaaaa
maaaaaaaaaaaaaaEEEaaaaaaaaaaaEEEEEYYYYYEEEaaaaaaaaaaaaaaaaaaaaaaaaaaaaaaaaaaaaaaaaaaaaaaaaaaaaaaaaaaaaaaaaaaaaEYYYYEaaaaaaaaaaaaaaaaaaaaaaaaaaaaaaaaaa
maaaaaaaaaaaaaaaaaaaaaaaaaaaaaaaaEYYYYYYYEEaaaaaaaaaaaaaaaaaaaaaaaaaaaaaaaaaaaaaaaaaaaaaaaaaaaaaaaaaaaaaaaaaaaEYYYEEaaaaaaaaaaaaaaaaaaaaaaaaaaaaaaaaaa
maaaaaaaaaaaaaaaaaaaaaaaaaaaaaaaaEEEEYYYYYEEaaaaaaaaaaaaaaaaaaaaaaaaaaaaaaaaaaaaaaaaaaaaaaaaaaaaaaaaaaaaaaaaaaEYYYEaaaaaaaaaaaaaaaaaaaaaaaaaaaaaaaaaaa
maaaaaaaaaaaaaaaaaaaaaaaaaaaaaaaaaaaEEEYYYYEaaaaaaaaaaaaaaaaaaaaaaaaaaaaaaaaaaaaaaaaaaaaaaaaaaaaaaaaaaaaaaaaaaEYYYEEaaaaaaaaaaaaaaaaaaaaaaaaaaaaaaaaaa
maaaaaaaaaaaaaaaaaaaaaaaaaaaaaaaaaaaaaEYYYYEEaaaaaaaaaaaaaaaaaaaaaaaaaaaaaaaaaaaaaaaaaaaaaaaaaaaaaaaaaaaaaaaaaEEYYYEEEaaaaaaaaaaaaaaaaaaaaaaaaaaaaaaaa
maaaaaaaaaaaaaaaaaaaaaaaaaaaaaaaaaaaaaEEEYYYEaaaaaaaaaaaaaaaaaaaaaaaaaaaaEEEEEEEaaaaaEEEEEaaaaaaaaaaaaaaaaaaaaaEYYYYYEEEEEEaaaaaaaaaaaaaaaaaaaaaaaaaaa
maaaaaaaaaaaaaaaaaaaaaaaaaaaaaaaaaaaaaaaEYYYEEEaaaaaaaaaaaaaaaaaaaaaaEEEEEYYEEEEEEaaEEYYYEEaaaaaaaaaaaaaaaaaaaaEEYYYYYYYYYEEEEEaaaaaaaaaaaaaaaaaaaaaaa
maaaaaaaaaaaaaaaaaaaaaaaaaaaaaaaaaaaaaaaEEYYYYEaaaaaaaaaaaaaaaaaaEEEEEYEYYYYYYYEYEEEEYYYYYEaaaaaaaaaaaaaaaaaaaaaEEYYYYYYYYYYYYEEEEEEaaaaaaaaaaaaaaaaaa
maaaaaaaaaaaaaaaaaaaaaaaaaaaaaaaaaaaaaaaaEEYYYEEaaaaaaaaaaaaaaEEEEYYYYYYYYYYYYYYYYYYYYYYYYEEaaaaaaaaaaaaaaaaaaaaaEEYYYYYYYYYYYYYYYEEEEEaaaaaaaaaaaaaaa
maaaaaaaaaaaaaaaaaaaaaaaaaaaaaaaaaaaaaaaaaEYYYYEaaaaaaaaaaaEEEEYYYYYYYYEEEEEEEEYYYYYYYYYYYYEaaaaaaaaaaaaaaaaaaaaaaEEEYYYYYYYYYYYYYYYYYEaaaaaaaaaaaaaaa
maaaaaaaaaaEEEEaaaaaaaaaaaaaaaaaaaaaaaaaaaEEYYYEaaaaaaaaEEEEYYYYYYYYYEEEaaaaaaEEEEYYYYYYYYYEaaaaaaaaaaaaaaaaaaaaaaaaEEEEEEEEYYYYYYYYYYEEaaaaaaaaaaaaaa
maaaaaaaaaaEYYEEaaaaaaaaaaaaaaaaaaaaaaaaaaaEEYYEEaaaaaEEEYYYYYYYYEEEEEaaaaaaaaaaaEEEYYYYYYYEEaaaaaaaaaaaaaaaaaaaaaaaaaaaaaaEEEYYYYYYYYYEaaaaaaaaaaaaaa
maaaaaaaaaaEYYYEaaaaaaaaaaaaaaaaaaaaaaaaaaaaEEYYEEaaEEEYYYYYYEEEEEaaaaaaaaaaaaaaaaaEEYYYYYYEEaaaaaaaaaaaaaaaaaaaaaaaaaaaaaaaaEEEYYYYYYYEEaaaaaaaaaaaaa
maaaaaaaaaaEYYYEaaaaaaaaaaaaaaaaaaaaaaaaaaaaaEYYYEEEEYYYYYEEEEaaaaaaaaaaaaaaaaaaaaaaEYYYYYEEaaaaaaaaaaaaaaaaaaaaaaaaaaaaaaaaaaaEEYYYYYYYEEaaaaaaaaaaaa
maaaaaaaaaEEEYYEEEEEEEEEEaaaaaaaaaaaaaaaaaaaaEEYYYYYYYYYEEEaaaaaaaaaaaaaaaaaaaaaaaaaEYYYYEEaaaaaaaaaaaaaaaaaaaaaaaaaaaaaaaaaaaaaEEYYYYYYYEEaaaaaaaaaaa
maaaaaaaaaEYYYYYYYYYYYYYEEEEEaaaaaaaaaaaaaaaaaEEYYYYYYEEEaaaaaaaaaaaaaaaaaaaaaaaaaaaEEEEEEaaaaaaaaaaaaaaaaaaaaaaaaaaaaaaaaaaaaaaaEEYYYYYYYEaaaaaaaaaaa
maaaaaaaaaEYYYYYYYYYYYYYYYYYEaaaaaaaaaaaaaaaaaaEYYYYYYEaaaaaaaaaaaaaaaaaaaaaaaaaaaaaaaaaaaaaaaaEEEEEEEEEaaaaaaaaaaaaaaaaaaaaaaaaaaEYYEYYYYEEaaaaaaaaaa
maaaaaaaaaEYYYYYYEYYYYYYYYYYEaaaaaaaaaaaaaaaaaaEEYYYYYEaaaaaaaaaaaaaaaaaaaaaaaaaaaaaaaaaaaaaaaEEYYYYYYYEEaaaaaaaaaaaaaaaaaaaaaaaaaEEEEEYYYEEaaaaaaaaaa
maaaaaaaaEEYYEYYEEEEEEYYYEEEEaaaaaaaaaaaaaaaaaaaEEYYYEEaaaaaaaaaaaaaaaaaaaaaaaaaaaaaaaaaaaaaaaEYYYYYYYYYEEEaaaaaaaaaaaaaaaaaaaaaaaaaaaEEYYYEaaaaaaaaaa
maaaaaaaaEYYYEYYEaaaaEEYYEaaaaaaaaaaaaaaaaaaaaaaEEYYYEaaaaaaaaaaaaaaaaaaaaaaaaaaaaaaaaaaaaaaaaEEEEYYYYYYYYEEEaaaaaaaaaaaaaaaaaaaaaaaaaaEYYYEaaaaaaaaaa
maaaaaaaaEYYYEYEEaaaaaEEEEaaaaaaaaaaaaaaaaaaaaaaEYYYYEaaaaaaaaaaaaaaaaaaaaaaaaaaaaaaaaaaaaaaaaaaaEEEEEYYYYYYEEaaaaaaaaaaaaaaaaaaaaaaaaaEYYYEaaaaaaaaaa
maaaaaaaEEYYYEEEaaaaaaaaaaaaaaaaaaaaaaaaaaaaaaaaEEYYYEaaaaaaaaaaaaaaaaaaaaaaaaaaaaaaaaaaaaaaaaaaaaaaaEEEYYYYYEEEaaaaaaaaaaaaaaaaaaaaaaaEYYYEaaaaaaaaaa
maaaaaaaEEYYYEEaaaaaaaaaaaaaaaaaaaaaaaaaaaaaaaaaaEYYYEaaaaaaaaaaaaaaaaaaaaaaaaaaaaaaaaaaaaaaaaaaaaaaaaaEEYYYYYYEEaaaaaaaaaaaaaaaaaaaaaaEYYYEaaaaaaaaaa
maaaaaaaEEEYYEEaaaaaaaaaaaaaaaaaaaaaaaaaaaaaaaaaaEYYYEaaaaaaaaaaaaaaaaaaaaaaaaaaaaaaaaaaaaaaaaaaaaaaaaaaEEYYYYYYEEaaaaaaaaaaaaaaaaaaaaaEYYYEaaaaaaaaaa
maaaaaaaaEEYYYEEaaaaaaaaaaaaaaaaaaaaaaaaaaaaaaaaaEYYYEaaaaaaaaaaaaaaaaaaaaaaaaaaaaaaaaaaaaaaaaaaaaaaaaaaaEEEYYYYYEEEaaaaaaaaaaaaaaaaaaaEYYYEaaaaaaaaaa
maaaaaaaEEYYYYYEEEEEEEEEEaaaaaaaaaaaaaaaaaaaaaaaaEYYYEaaaaaaaaaaaaaaaaaaaaaaaaaaaaaaaaaaaaaaaaaaaaaaaaaaaaaEEYYYYYYEaaaaaaaaaaaaaaaaaaaEYYYEaaaaaaaaaa
maaaaaaEEYYYYYYYYYEEEEEEEEEEaaaaaaaaaaaaaaaaaaaaaEYYYEaaaaaaaaaaaaaaaaaaaaaaaaaaaaaaaaaaaaaaaaaaaaaaaaaaaaaEEEYYYYYEEaaaaaaaaaaaaaaaaaEEYYYEaaaaaaaaaa
maaaaaaEYYYYYYYYYYYYYYYYYYYEEEaaaaaaaaaaaaaaaaaaEEYYYEaaaaaaaaaaaaaaaaaaaaaaaaaaaaaaaaaaaaaaaaaaaaaaaaaaaaaaaEEYYYYYEaaaaaaaaaaaaaaaaEEYYYYEaaaaaaaaaa
maaaaaaEYYYYYYYYYYYYYYYYYYYYYEEaaaaaaaaaaaaaaaaaEYYYYEaaaaaaaaaaaaaaaaaaaaaaaaaaaaaaaaaaaaaaaaaaaaaaaaaaaaaaaaEEYYYYEEaaaaaaaaaaaaaaaEEYYYEEaaaaaaaaaa
maaaaaaEEYYYYYYYYYYYYYYYYYYYYYEEEEEaaaaaaaaaaaaaEYYYYEaaaaaaaaaaaaaaaaaaaaaaaaaaaaaaaaaaaaaaaaaaaaaaaaaaaaaaaaaEEYYYYEaaaaaaaaaaaaaaEEYYYYEaaaaaaaaaaa
maaaaaaaEEYYYYYEEEEEEEEEEYYYYYYYEEEEEEEEaaaaaaaEEYYYEEaaaaaaaaaaaaaaaaaaaaaaaaaaaaaaaaaaaaaaaaaaaaaaaaaaaaaaaaaaEEYYYEaaaaaaaaaaaaaEEEYYYEEaaaaaaaaaaa
maaaaaaaEYYYYEEEaaaaaaaaEEEEYYYYYEYEYYYEEaaaaaaEYYYYEEaaaaaaaaaaaaaaaaaaaaaaaaaaaaaaaaaaaaaaaaaaaaaaaaaaaaaaaaaaaEYYYEEaaaaaaaaaaaaEEYYYYEaaaaaaaaaaaa
maaaaaaaEYYYEEaaaaaaaaaaaaaEEEYYYYYYYYYYEaaaaaaEYYYYYEEaaaaaaaaaaaaaaaaaaaaaaaaaaaaaaaaaaaaaaaaaaaaaaaaaaaaaaaaaaEEYYYEEaaaaaaaaaaaEYYYYEEaaaaaaaaaaaa
maaaaaaaEYYYEaaammmmmmmaaaaaaEEYYYYYYYYYEEaaaaaEEYYYYYEaaaaaaaaaaaaaaaaaaaaaaaaaaaaaaaaaaaaaaaaaaaaaaaaaaaaaaaaaaaEYYYYEEEEEaaaaaaaEYYYEEaaaaaaaaaaaaa
maaaaaaEEYYYEaaamaaaaammaaaaaaEYYYYYYYYYYEaaaaaaEEYYYYEaaaaaaaaaaaaaaaaaaaaaaaaaaaaaaaaaaaaaaaaaaaaaaaaaaaaaaaaaaaEEYYYYYYYEEEaaaaaEYYYEaaaaaaaaaaaaaa
maaaaaaEYYYYEaaamaaaaaaamaaaaaEYYYYYYYYYEEaaaaaaaEEYYYEaaaaaaaaaaaaaaaaaaaaaaaaaaaaaaaaaaaaaaaaaaaaaaaaaaaaaaaaaaaaEYYYYYYYYYEEaaaaEYYEEaaaaaaaaaaaaaa
maaaaaaEYYYEEaaamaaaaaaammaaaEEYYYYYYYYYYEaaaaaaaaEYYYEEaaaaaaaaaaaaaaaaaaaaaaaaaaaaaaaaaaaaaaaaaaaaaaaaaaaaaaaaaaaEYYYYYYYYYYEEEEaEYYEEaaaaaaaaaaaaaa
maaaaaaEYYYEaaaamaaaaaaaamaaaEYYYYYYYYYYYEaaaaaaaaEYYYYEaaaaaaaaaaaaaaaaaaaaaaaaaaaaaaaaaaaaaaaaaaaaaaaaaaaaaaaaaaEEYYYYYYYYYYYYYEEEYYYEaaaaaaaaaaaaaa
maaaaaEEYYYEaaaamaaaaaaaammaaEYYYYYYYYYYYEaaaaaaaaEEYYYEEEEEEEEEEEEEEEEEEaaaaaaaaaaaaaaaaaaaaaaaaaaaaaaaaaaaaaaaaEEYYYYYEEEEYYYYYYEEYYYEaaaaaaaaaaaaaa
maaaaaEYYYEEaaaamaaaaaaaaamaaEYYYYYYYYYYEEaaaammaaaEYYYEEYYYYYYYYYYYYYYEEEaaaaaaaaaaaaaaaaaaaaaaaaaaaaaaaaaaaaaaEEYYYYYEEaaEEYYYYYYYYYYEaaaaaaaaaaaaaa
maaaaaEEYYEEaaaammaaaaaaaammaEEEYYYYYYYEEaaaammaaaaEYYYYYYYYYYYYYYYYYYYYYEEEaaaaaaaaaaaaaaaaaaaaaaaaaaaaaaaaaEEEEYYYYEEEaaaaEEEYYYYYYYYEaaaaaaaaaaaaaa
maaaaaEYYYEEaaaaamaaaaaaaaammaaEEYYYYYEEEaaammaaaaEEYYYYYYYYYYYYYYYYYYYYYYYEEEaaaaaaaaaaaaaaaaaaaaaaaaaaaaaEEEYYYYYYEEaaaaaaaaEEEEYYYYYEaaaaaaaaaaaaaa
maaaaaEEYYYEEaaaammaaaaaaaaammaaEEYYYYEaaaammaaaaEEYYYYYEEEEEEEEEEEEYYYYYYYYEEaaaaaaaaaaaaaaaEEEEaaaaaaaaaEEYYYYYYEEEaaaaaaaaaaaaEEEYYYEaaaaaaaaaaaaaa
maaaaaaEYYYYEEaaaamaaaaaaaaaamaaaEEYYEEaaammaaaEEEYYYYEEEaaaaaaaaaaEEEYYYYYYYEaaaaaaaaaaaaaaaEYYEEaaaaaaEEEYYYYYYEEaaaaaaaaaaaaaaaaEEEEEaaaaaaaaaaaaaa
maaaaaaEEYYYYEaaaammaaaaaaaaammaaaEEEEaaammaaaEEYYYYYEEaaaaaaaaaaaaaaEEEYYYYYEEaaaaaaaaaaaaaaEYYYEEEaaaEEYYYYYYYEEaaaaaaaaaaaaaaaaaaaaaaaaaaaaaaaaaaaa
maaaaaaaEYYYEEaaaaamaaaaaaaaaammaaaaaaaammaaaEEYYYYYEEaaaaaaaaaaaaaaaaaEEYYYYYEaaaaaaaaaaaaaaEEYYYEEEEEEYYYYYYYEEaaaaaaaaaaaaaaaaaaaaaaaaaaaaaaaaaaaaa
mEEEEEEEEEYYYEEEaaamaaaaaaaaaaamaaaaaaammaaaEEYYYYYEEaaaaaaaaaaaaaaaaEEEEEYYYYEaaaaaaaaaaaaaaaEEYYYYYEEYYYYYEEEEaaaaaaaaaaaaaaaaaaaaaaaaaaaaaaaaaaaaaa
mEEEEEEEEYYYYYYEaaamaaaaaaaaaaammaaaaammaaaEEYYYYEEEaaaaaaaaaaaaaaaaEEYYYYYYYYEaaaaaaaaaaaaaaaEEYYYYYYYYYYYEEaaaaaaaaaaaaaaaaaaaaaaaaaaaaaaaaaaaaaaaaa
mEEEEEEEEYYYYYYEaaammaaaaaaaaaaammmammmaEEEEYYYYYEaaaaaaaaaaaaaaaaaEEYYYYYYYYYEaaaaaaaaaaaaaaaaEEYYYYYYYYYEEaaaaaaaaaaaaaaaaaaaaaaaaaaaaaaaaaaaaaaaaaa
mEEEEEEEEEEYYYYEaaaamaaaaaaaaaaaaammmaaaEEEYYYYYEEaaaaaaaaaaaaaaaEEEYYYYYYYYYYEaaaaaaaaaaaaaaaaaEEYYYYYYYEEaaaaaaaaaaaaaaaaaaaaaaaaaaaaaaaaaaaaaaaaaaa
mEEEEEEEEEEEYYYEaaaamaaaaaaaaaaaaammaaaEEYYYYYEEEaaaaaaaaaaaaaaaaEEYYYYYYEEYYEEaaaaaaaaaaaaaaaaaaEEYYYYYYEaaaaaaaaaaaaaaaaaaaaaaaaaaaaaaaaaaaaaaaaaaaa
mEEEEEEEEEEYYYYEaaaamaaaaaaaaaaaammaaaaEYYYYYEEEEEaaaaaaaaaaaaaaaaEYYYYYYYEEEEaaaaaaaaaaaaaaaaaaaaEYYYYYYEaaaaaaaaaaaaaaaaaaaaaaaaaaaaaaaaaaaaaaaaaaaa
mEEEEEEEEEEEYYEEaaaamaaaaaaaaaaammaaaaEEYYYYYYYYYEEEEaaaaaaaaaaaaaEYYYYYYYYEEaaaaaaaaaaaaaaaaaaaaaEEYYYYYEaaaaaaaaaaaaaaaaaaaaaaaaaaaaaaaaaaaaaaaaaaaa
mEEEEEEEEEEYYYYEaaaamaaaaaaaaaaamaaaaEEYYYYYYYYYYYYYEEEaaaaaaaaaaaEYYYYYYYYYEaaaaaaaaaaaaaaaaaaaaaaEYYYYYEaaaaaaaaaaaaaaaaaaaaaaaaaaaaaaaaaaaaaaaaaaaa
mEEEEEEEEEYYYYEEaaaamaaaaaaaaaammaaaEEYYYYYYYYYYYYYYYYEEEaaaaaaaaaEEYYYYYYYYEaaaaaaaaaaaaaaaaaaaaaaEEYYYYEaaaaaaaaaaaaaaaaaaaaaaaaaaaaaaaaaaaaaaaaaaaa
mEEEEEEEEYYYYYEEEaaamaaaaaaaaaamaaaEEYYYYYYYEEYYYYYYYYYEEaaaaaaaaaEYYYYYYYYYEaaaaaaaaaaaaaaaaaaaaaaaEEYYYEaaaaaaaaaaaaaaaaaaaaaaaaaaaaaaaaaaaaaaaaaaaa
mEEEEEEEEEYYYYYYEaaamaaaaaaaaaamaaaEYYYYYYYEEEEYYYYYYYYYEEaaaaaaaaEEEYYYYYYYEEaaaaaaaaaaaaaaaaaaaaaaaEYYYEaaaaaaaaaaaEEEEEEEEEEEaaaaaaaaaaaaaaaaaaaaaa
mEEEEEEEEEYYYYEEEaaamaaaaaaaaammaaaEYYYYYYEEaaEEYYYYYYYYYEEaaaaaaaaaEEYYYYYYYEaaaaaaaaaaaaaaaaaaaaaaaEYYYEaaaaaaaaaaaEEYYYYYYYYEEEaaaaaaaaaaaaaaaaaaaa
mEEEEEEEEYYYYYEaaaaamaaaaaaaaamaaaaEYYYYYEEaaaaEEYYYYYYYYYEEaaaaaaaaaEEEEEEEEEaaaaaaaaaaaaaaaaaaaaaaaEYYYEaaaaaaaaaaEEYYYYYYYYYYYEEaaaaaaaaaaaaaaaaaaa
mEEEEEEEEYYYYYEaaaamaaaaaaaaammaaaaEYYYYYEaaaaaaEEYYYYYYYYYEEaaaaaaaaaaaaaaaaaaaaaaaaaaaaaaaaaaaaaaaaEYYYEaaaaaaaaaaEEYYYYYYYYYYYYEEaaaaaaaaaaaaaaaaaa
mEEEEEEEYYYYYYEaaaamaaaaaaaaamaaaaEEYYYYEEaaaaaaaEEEEYYYYYYYEEaaaaaaaaaaaaaaaaaaaaaaaaaaaaaaaaaaaaaaEEYYYEaaaaaaaaaEEYYYYYYYYYYYYYYEaaaaaaaaaaaaaaaaaa
mEEEEEEEEYYYYEEaaaamaaaaaaaaamaaaaEYYYYYEaaaaaaaaaaaEEYYYYYYYEEEEaaaaaaaaaaaaaaaaaaaaaaaaaaaaaaaaaaaEYYYYEaaaaaaaEEEYYYYYYYYYYYYYYYEaaaaaaaaaaaaaaaaaa
mEEEEEEEEYYYYEaaaamaaaaaaaaaamaaaaEYYYYEEaaaaaaaaaaaaEEYYYYYYYYYEEEaaaaaaaaaaaaaaaaaaaaaaaaaaaaaaaaEEYYYEEaaaaaaaEEYYYYYYYYYYYYYYYYEaaaaaaaaaaaaaaaaaa
mEEEEEEEYYYYYEaaaamaaaaaaaaaamaaaaEYYYYEaaaaaaaaaaaaaaEEYYYYYYYYYYEEEEEEaaaaaaaEEEEEEEaaaaaaaaaaaaaEYYYYEaaaaaaaEEYYYYYYYYYYYYYYYYYEaaaaaaaaaaaaaaaaaa
mEEEEEEEEEYYYEaaammaaaaaaaaaamaaaEEEYYYEaaaaaaaaaaaaaaaEEYYYYYYYYYYYYYYEEEEaaEEEYYYYYEEEEEEEaaaaaaEEYYYYEaaaaaaEEYYYYYYYYYYYYYYYYYYEaaaaaaaaaaaaaaaaaa
mEEEEEEEEEYYYEaaamaaaaaaaaammmaaaEYYYYYEaaaaamaaaaaaaaaaEEYYYYYYYYYYYYYYYYEaEEYYYYYYYYYYEYYEEEaaaEEYYYYYEaaaaaaEEYYYYYYYYYYYYYYYYYYEaaaaaaaaaaaaaaaaaa
mEEEEEEEEEYYYEaaammmmmmmmmmmaaaaaEYYYYYEaaaaamaaaaaaaaaaaEEYYYYYYYYYYYYYYEEEEYYYYYYYYYYYYYYYYEEEEEYYYYYEEaaaaEEEYYYYYYYYYYYYYYYYYYYEaaaaaaaaaaaaaaaaaa
mEEEEEEEEEYYYEaaaaaaaaaaaaaaaaaaEEYYYYYEaaaaammaaaaaaaaaaaEEEYYYYYYYYYYYYEEEYYYYYYYYYYYYYYYYYYYYEEYYYYYEEEEEEEYYYYYYYYYYYYYYYYYYYYYEaaaaaaaaaaaaaaaaaa
mEEEEEEEEEYYYEEaaaaaaaEEEEEEEaaaEYYYYYYEaaaaaammaaaaaaaaaaaaEEEYYYYYYYYYYYYYYYYYYYYYYYYYYYYYYYYYYYYYYYYYYYYYYYYYYYYYYYYYYYYYYYYYYYYEaaaaaaaaaaaaaaaaaa
mEEEEEEEEEYYYEEaaaaaEEEYYYYYEEEEEYYYYYYEaaaaaaammaaaaaaaaaaaaaEEEEEYYYYYYYYYYYYYYYYYYYYYYYYYYYYYYYYYYYYYYYYYYYYYYYYYYYYYYYYYYYYYYYYEaaaaaaaaaaaaaaaaaa
mEEEEEEEEEYYYYEaaaEEEYYYYYYYYYYYYYYYYYYEaaaaaaaammaaaaaaaaaaaaaaaaEEEEEEYYYYYYYEEEEEEEEEEYYYYEEEEEEEEEEEEEEEEEEYYYYYYYYYYYYYYYYYYYYEaaaaaEEEaaaaaaaaaa
mEEEEEEEEYYYYYEaEEEYYYYYYYYYYYYYYYYYYYYEaaaaaaaaammaaaaaaaaaaaaaaaaaaaaEYYYYEEEEaaaaaaaaEEYYYYEaaaaaaaaaaaaaaaEEEEYYYYYYYYYYYYYYYYYEaaaaEEYEEaaaaaaaaa
mEEEEEEEEYYYYYEEEYYYYYYYYYYYYYYYYYYYYYYEEaaaaaaaaammaaaaaaaaaaaaaaaaaaEEYYYYEaaaaaaaaaaaaEEYYYEaaaaaaaaaaaaaaaaEEEEYYYYYYYYYYYYYYYEEaaaaEYYYEEaaaaaaaa
mEEEEEEEEEYYYYEYYYYYYYYYYEYYYYYYYYYYYYYYEEaaaaaaaaammaaaaaaaaaaaaaaaaEEYYYYYEaaaaaaaaaaaaaEYYYEaaaaaaaaaEEEEaaaaaaEEYYYYYYYYYYYYYEEaaaaaEYYYYEEaaaaaaa
mEEEEEEEEEYYYYYYYYYYYYYYEEEEYYYYEYYYYYYYYEEaaaaaaaaammaaaaaaaaaaaaaaaEYYYYYYEaaaaaaaaaaaaaEYYYEaaaaaaaaaEYYEEEaaaaaEYYYYYYYYYYYYEEaaaaaaEYYYYYEEEaaaaa
mEEEEEEEEEYYYYYYYYYEEEEEEEEEEEEEEEEEYYYYYYEEaaaaaaaaamaaaaaaaaaaaaaaaEYYYYYEEaaaaaaaaaaaaaEEYYEaaaaaaaaaEYYYYEEaaaaEYYYYYYYYYYYEEaaaaaaaEYYYYYYEEaaaaa
mEEEEEEEEYYYYYYYYYEEaaaaaaaaaaaaaaaEYYYYYYYEaaaaaaaaamaaaaaaaaaaaaaaaEEYYYEEaaaaaaaaaaaaaaaEYYEEaaaaaaaaEEEYYYEaaaaEEYYYYYYYYEEEaaaaaaaaEYYYYYYEEaaaaa
mEEEEEEEYYYYYYYYYEEaaaaaaaaaaaaaaaaEEEYYYYYEEaaaaaaaammaaaaaaaaaaaaaEEYYYEEaaaaaaaaaaaaaaaaEYYYEaaaaaaaaaaEEYYEaaaaaEEEEEEEEEEaaaaaaaaaaEYYYYYYEEaaaaa
mEEEEEEEYYYYYYYEEEaaaaaaaaaaaaaaaaaaaEEEYYYYEEEaaaaaaamaaaaaaaaaaaaEEYYYYEaaaaaaaaaaaaaaaaaEYYYEEaaaaaaaaaaEYYEEaaaaaaaaaaaaaaaaaaaaaaaEEYYYYYYEEaaaaa
mEEEEEEEYYYYYEEEaaaaaaaaaaaaaaaaaaaaaaaEEEYYYYEaaaaaaamaaaaaaaaaaaEEYYYYEEaaaaaaaaaaaaaaaaaEEYYYEaaaaaaaaaaEYYYEaaaaaaaaaaaaaaaaaaaaaaaEEYYYYYYEaaaaaa
mEEEEEEYYYYYYEaaaaaaaaaaaaaaaaaaaaaaaaaaaEYYYYEaaaaaaammaaaaaaaaaaEYYYYYEaaaaaaaaaaaaaaaaaaaEYYYEEaaaaaaaaEEYYYEaaaaaaaaaaaaaaaaaaaaaaaaEEYYYYYEaaaaaa
mEEEEEEEYYYYYEaaaaaaaaaaaaaaaaaaaaaaaaaaaEEYYYEEaaaaaaamaaaaaaaaaaEEYYYEEaaaaaaaaaaaaaaaaaaaEYYYYEEaaaaaaEEYYYYEaaaaaaaaaaaaaaaaaaaaaaaaaEYYYYYEaaaaaa
mEEEEEEEYYYYYEaaaaaaaaaaaaaaaaaaaaaaaaaaaaEEYYYEaaaaaaamaaaaaaaaaEEYYYEEaaaaaaaaaaaaaaaaaaaaEEYYYYEaaaaaEEYYYEEEaaaaaaaaaaaaaaaaaaaaaaaaaEYYYYYEaaaaaa
mEEEEEEEEEYYYEaaammmmmmmmmmmmmmmmmmmmmaaaaaEYYYEEaaaaaamaaaaaaaaEEYYYYEaaaaaaaaaaaaaaaaaaaaaaEYYYYEaaaaaEEYYEEaaaaaaaaaaaaaaaaaaaaaaaaaaaEYYYYYEaaaaaa
mEEEEEEEEEYYYEaaamaaaaaaaaaaaaaaaaaaamaaaaaEYYYYEaaaaaamaaaaaaaEEYYYYYEaaaaaaaaaaaaaaaaaaaaaaEEYYYEEaaEEEYYYEaaaaaaaaaaaaaaaaaaaaaaaaaaaEEYYYYYEaaaaaa
mEEEEEEEEEYYYEaaamaaaaaaaaaaaaaaaaaaamaaaaaEEYYYEaaaaaamaaaaaaEEYYYYYEEaaaaaaaaaaaaaaaaaaaaaaaEYYYYEEEEYYYYEEaaaaaaaaaaaaaaaaaaaaaaaaaaaEYYYYYYEaaaaaa
mEEEEEEEEYYYYEaaamaaaaaaaaaaaaaaaaaaamaaaaaaEEYYEaaaaaamaaaaaaEYYYYYYEaaaaaaaaaaaaaaaaaaaaaaaaEEEYYYEYYYYYEEaaaaaaaaaaaaaaaaaaaaaaaaaaaaEYYYYYYEaaaaaa
mEEEEEEEYYYYYEaaamaaaaaaaaaaaaaaaaaaamaaaaaEEYYEEaaaaaamaaaaaaEEYYYYEEaaaaaaaaaaaaaaaaaaaaaaaaaaEYYYYYYYYEEaaaaaaaaaaaaaaaaaaaaaaaaaaaaaEYYYYYYEaaaaaa
mEEEEEEYYYYYYEaaamaaaaaaaaaaaaaaaaaaamaaaaEEYYYEaaaaaaamaaaaaaEYYYYEEaaaaaaaaaaaaaaaaaaaaaaaaaaaEEYYYYYEEEaaaaaaaaaaaaaaaaaaaaaaaaaaaaaEEYYYYYEEaaaaaa
mEEEEEYYYYYYYEaaamaaaaaaaaaaaaaaaaaaamaaaaEYYYEEaaaaaaamaaaaaaEYYYEEaaaaaaaaaaaaaaaaaaaaaaaaaaaaaEEYYYYYEEEEaaaaaaaaaaaaaaaaaaaaaaaaaaaEYYYYYYEaaaaaaa
mEEEEYYYYYYEEEaaamaammmmmmmmmmmmmmmmmmaaaEEYYYEaaaaaaaamaaaaaaEYYYEaaaaaaaaaaaaaaaaaaaaaaaaaaaaaaaEEYYYYYYYEEaaaaaaaaaaaaaaaaaaaaaaaaaaEYYYYYEEaaaaaaa
mEEEEYYYMYYEaaaammaamaaaaaaaaaaaaaaaaaaaEEYYYYEaaaaaaaamaaaaaaEYYYEEaaaaaaaaaaaaaaaaaaaaaaaaaaaaaaaEEEYYYYYYEEEEaaaaaaaaaEEEEEEEEaaaaaaEYYYYYEaaaaaaaa
mEEEYYYYYYYEaaaamaaamaaaaaaaaaaaaaaaaaaEEYYYYEEaaaaaaaamaaaaaaEYYYYEaaaaaaaaaaaaaaaaaaaaaaaaaaaaaaaaaEEYYYYYYYYEEaaaaaaaEEYYEYYYEEEaaaaEYYYYYEaaaaaaaa
mEEEYYYYYYYEaaammaaamaaaEEEaaaaaaaaaaaEEYYYYEEaaaaaaaaamaaaaaaEYYYYEaaaaaaaaaaaaaaaaaaaaaaaaaaaaaaaaaaEEEYYYYYYYEEaaaaaEEYYYYYYYYYEEaaaEYYYYEEaaaaaaaa
mEEEYYYYYYYEEammaaaamaaaEYEEaaaaaaaaaaEEYYYEEaaaaaaaaammaaaaaaEYYYYEEaaaaaaaaaaaaaaaaaaaaaaaaaaaaaaaaaaaEEEEYYYYYEaaaaaEYYYYEEEYYYYEaaEEYYYYEEaaaaaaaa
mEEZZZeQeeZZEamaaaaamaaEEYYEaaaaaaaaEEEYYEEEaaaaaaaaaamaaaaaaaEEYYYYEEEEEaaaaaaaaaaaaaaaaaaaaaaaaaaaaaaaaaaEEYYYYEaaaaaEEEEYEaEYYYYEEEEYYYYEEaaaaaaaaa
mEEekkkzkxxZEamaaaaamaaEYYYEaaaaaaaEEYYYEEaaaaaaaaaaaamaaaaaaaaEYYYYYYYYEEaaaaaaaaaaaaaaaaaaaaaaaaaaaaaaaaaaEEEEEEaaaaaaaaEEEaEEYYYYEEYYYYYEaaaaaaaaaa
mEEZkkkVRpCZEamaaaaamaEEYYYEEaaaaaEEYYYEEaaaaaaaaaaaaamaaaaaaaaEEYYYYYYYYEaaaaaaaaaaaaaaaaaaaaaaaaaaaaaaaaaaaaaaaaaaaaaaaaaaaaaEEYYYYYYYYEEEaaaaaaaaaa
mEEZTkkkkLkeEamaaaaamaEYYYYYEaaaaEEYYYYEaaaaaaaaaaaaaamaaaaaaaaaEEEYYYYYYEEEEaaaaaaaaaaaaaaaaaaaaaaaaaaaaaaaaaaaaaaaaaaaaaaaaaaaEEYYYYYYYEaaaaaaaaaaaa
mEEZTkkkkzkZEEmaaaaamaEYYYYYEaaEEEYYYYYEaaaaaaaaaaaaaamaaaaaaaaaaaEEEYYYYYYYEEEEaaaaaaaaaaaaaaaaaaaaaaaaaaaaaaaaaaaaaaaaaaaaaaaaaEEYYYYYEEaaaaaaaaaaaa
mEEZTykkklkeEEmaaaaamaEEYYYYEEEEYYYYYYEEaaaaaaaaaaaaaamaaaaaaaaaaaaaEEYYYYYYYYYEEEEEEaaaaaaaaaaaaaaaaaaaaaaaaaEEEEEEEEEEaaaaaaaaEEYYYYYEEaaaaaaaaaaaaa
mEEeTkkkkzkZEEmaaaaamaaEEYYYEYYYYYYYEEEaaaaaaaaaaaaaaamaaaaaaaaaaaaaaEEEYYYYYYYYYYEEEEaaaaaaaaaaaaaaaaEEEEEEEEEYYYYYYYYEEaaaaaEEEYYYYYEEaaaaaaaaaaaaaa
mEEZkkkkkzkZEEmaaaaamaaaEYYYYYYYYYEEEaaaaaaaaaaaaaaammmaaaaaaaaaaaaaaaaEEEEYYYYYYYYYYEEEEEEEaaaaaaaaEEEYYYYYEYYYYYYYYYYYEEEEEEEYYYYYYEEaaaaaaaaaaaaaaa
mEEZkkkIkzkZEEmaaaaamaaaEEYYYYYYYEEaaaaaaaaaaaaaaaaamaaaaaaaaaaaaaaaaaaaaaEEEEYYYYYYYYYYYYYEEEEEEEaEEEYYYYYYYYYYYEEEEYYYYEYYEYYYYYYYEEaaaaaaaaaaaaaaaa
mEEeFUkkkLkeEEmaaaaamaaaaEEYYYYYEEaaaaaaaammmmmmmmmmmaaaaaaaaaaaaaaaaaaaaaaaaEEEEEEEYYYYYYYYYYYYYEEEEYYYYYYYYYYEEEaaEYYYYYYYYYYYYYEEEaaaaaaaaaaaaaaaaa
mEEZXdddddoZEEmaaaaamaaaaaEEEEEEEEaaaaaaaamaaaaaaaaaaaaaaaaaaaaaaaaaaaaaaaaaaaaaaaaEEEEEEYYYYYYYYYYYYYYYYYEEEEEEaaaaEYYYYYYYYYYYYEEaaaaaaaaaaaaaaaaaaa
mEEZeZeZZeeZEEmaaaaamaaaaaaaaaaaaaaaaaaaaamaaaaaaaaaaaaaaaaaaaaaaaaaaaaaaaaaaaaaaaaaaaaaEEEEYYYYYYYYYYYYYEEaaaaaaaaaEYYYYYYYYYEEEEaaaaaaaaaaaaaaaaaaaa
mEEEEEEEEEEEEEmaaaaammmmmmmmmmmmmmmmmmmmmmmaaaaaaaaaaaaaaaaaaaaaaaaaaaaaaaaaaaaaaaaaaaaaaaaEEEEEEEEEEEEEEEaaaaaaaaaaEEEEEEEEEEEaaaaaaaaaaaaaaaaaaaaaaa
mEEEEEEEEEEEEEmaaaaaaaaaaaaaaaaaaaaaaaaaaaaaaaaaaaaaaaaaaaaaaaaaaaaaaaaaaaaaaaaaaaaaaaaaaaaaaaaaaaaaaaaaaaaaaaaaaaaaaaaaaaaaaaaaaaaaaaaaaaaaaaaaaaaaaa
mmmmmmmmmmmmmmmaaaaaaaaaaaaaaaaaaaaaaaaaaaaaaaaaaaaaaaaaaaaaaaaaaaaaaaaaaaaaaaaaaaaaaaaaaaaaaaaaaaaaaaaaaaaaaaaaaaaaaaaaaaaaaaaaaaaaaaaaaaaaaaaaaaaaaa
"}
